add = ['add', 'dad']
aft = ['aft', 'fat']
adi = ['aid', 'ida']
aim = ['aim', 'ami', 'mia']
alm = ['alm', 'lam', 'mal']
alt = ['alt', 'lat']
amt = ['amt', 'mat']
adn = ['and', 'dan', 'dna']
any = ['any', 'nay']
apt = ['apt', 'pat', 'tap']
aer = ['are', 'ear', 'era']
art = ['art', 'rat', 'tar']
aps = ['asp', 'pas', 'sap', 'spa']
atu = ['aut', 'tau']
anw = ['awn', 'wan']
abd = ['bad', 'dab']
abn = ['ban', 'nab']
abt = ['bat', 'tab']
ben = ['ben', 'neb']
bin = ['bin', 'nib']
bgo = ['bog', 'gob']
bor = ['bro', 'orb', 'rob']
bnu = ['bun', 'nub']
bsu = ['bus', 'sub']
buy = ['buy', 'byu']
acw = ['caw', 'wac']
cdo = ['cod', 'doc']
adm = ['dam', 'mad']
del = ['del', 'led']
dew = ['dew', 'wed']
din = ['din', 'ind']
deo = ['doe', 'ode']
dno = ['don', 'nod']
eeg = ['eeg', 'gee']
ekl = ['elk', 'lek']
egr = ['erg', 'reg']
eps = ['esp', 'sep']
eew = ['ewe', 'wee']
afr = ['far', 'raf']
agl = ['gal', 'lag']
agr = ['gar', 'rag']
egl = ['gel', 'leg']
gnu = ['gnu', 'gun']
gmu = ['gum', 'mug']
hip = ['hip', 'phi']
how = ['how', 'who']
ikn = ['ink', 'kin']
int = ['int', 'nit', 'tin']
eir = ['ire', 'rei']
ist = ['its', 'sit']
ajm = ['jam', 'maj']
elo = ['leo', 'ole']
lop = ['lop', 'plo']
low = ['low', 'owl']
anp = ['nap', 'pan']
inp = ['nip', 'pin']
not = ['not', 'ont', 'ton']
now = ['now', 'own', 'won']
opt = ['opt', 'pot', 'top']
eow = ['owe', 'woe']
apy = ['pay', 'yap']
ipt = ['pit', 'tip']
ips = ['psi', 'sip']
anr = ['ran', 'rna']
ary = ['ray', 'rya']
asw = ['saw', 'was']
esu = ['sue', 'use']
etu = ['tue', 'ute']
abbe = ['abbe', 'babe']
abcs = ['abcs', 'cabs', 'scab']
abet = ['abet', 'bate', 'beat', 'beta']
abtu = ['abut', 'tabu', 'tuba']
aces = ['aces', 'case']
aclu = ['aclu', 'caul']
acen = ['acne', 'cane']
acot = ['acto', 'coat', 'taco']
acly = ['acyl', 'clay', 'lacy']
aden = ['aden', 'dane', 'dean']
aeor = ['aero', 'orae']
afor = ['afro', 'faro', 'fora']
adeg = ['aged', 'egad']
aegs = ['ages', 'sage']
adei = ['aide', 'idea']
aeil = ['aiel', 'ilea']
aims = ['aims', 'siam']
airy = ['airy', 'yair']
aaln = ['alan', 'anal']
aels = ['ales', 'sale', 'seal']
aiil = ['alii', 'ilia']
aalm = ['alma', 'lama', 'mala']
aelo = ['aloe', 'olea']
alos = ['also', 'laos', 'sola']
almu = ['alum', 'maul']
aemx = ['amex', 'exam']
amos = ['amos', 'soma']
aenw = ['anew', 'wane', 'wean']
anno = ['anno', 'anon']
aent = ['ante', 'neat']
amnu = ['anum', 'manu']
achr = ['arch', 'char']
aers = ['ares', 'ears', 'eras', 'rase', 'sear', 'sera']
amrs = ['arms', 'mars', 'rams']
arst = ['arts', 'rats', 'star', 'tars', 'tsar']
alry = ['aryl', 'lyra']
anss = ['assn', 'sans']
amot = ['atom', 'moat', 'mota']
antu = ['aunt', 'tuna']
adiv = ['avid', 'diva']
aivv = ['aviv', 'viva']
alsw = ['awls', 'laws', 'slaw']
arwy = ['awry', 'wary']
aesy = ['ayes', 'easy', 'yeas']
abht = ['baht', 'bath']
abek = ['bake', 'beak']
aben = ['bane', 'bean']
abdr = ['bard', 'brad', 'drab']
abnr = ['barn', 'bran']
abst = ['bast', 'bats', 'stab', 'tabs']
abem = ['beam', 'bema']
been = ['been', 'bene']
benr = ['bern', 'nebr']
besy = ['beys', 'byes']
bins = ['bins', 'isbn', 'nibs']
blot = ['blot', 'bolt']
belu = ['blue', 'lube']
beor = ['boer', 'bore', 'robe']
bilo = ['boil', 'lobi']
bnoo = ['bono', 'boon']
boss = ['boss', 'sobs']
abgr = ['brag', 'garb', 'grab']
bors = ['bros', 'orbs', 'robs']
bnsu = ['buns', 'nubs', 'snub']
brsu = ['burs', 'rubs', 'urbs']
bhsu = ['bush', 'hubs']
bstu = ['bust', 'stub', 'tubs']
acef = ['cafe', 'face']
acky = ['caky', 'yack']
aclm = ['calm', 'clam']
acns = ['cans', 'scan']
acps = ['caps', 'spca']
acpr = ['carp', 'crap']
acsw = ['caws', 'wacs']
acht = ['chat', 'tach']
chit = ['chit', 'itch']
cino = ['cion', 'coin', 'coni', 'icon']
clot = ['clot', 'colt']
acox = ['coax', 'coxa']
cdos = ['cods', 'docs']
cilo = ['coil', 'coli', 'loci']
ceno = ['cone', 'once']
coot = ['coot', 'octo']
cops = ['cops', 'scop']
copr = ['corp', 'crop', 'proc']
ceov = ['cove', 'voce']
acmr = ['cram', 'marc']
crsu = ['crus', 'curs']
cdeu = ['cued', 'duce']
ceru = ['cure', 'ecru']
adem = ['dame', 'edam', 'made', 'mead']
adnr = ['darn', 'nard', 'rand']
adnw = ['dawn', 'wand']
ddei = ['dedi', 'died']
deep = ['deep', 'pede']
adej = ['deja', 'jade']
demo = ['demo', 'dome', 'mode']
dent = ['dent', 'tend']
desu = ['deus', 'dues', 'sued', 'used']
cdei = ['dice', 'iced']
deim = ['diem', 'dime', 'idem']
deit = ['diet', 'edit', 'tide', 'tied']
diks = ['disk', 'kids', 'skid']
deor = ['doer', 'redo', 'rode']
dgos = ['dogs', 'gods']
dilo = ['doli', 'idol', 'lido']
deno = ['done', 'node']
dnos = ['dons', 'nods']
door = ['door', 'odor', 'rood']
deot = ['dote', 'toed']
adrw = ['draw', 'ward']
dopr = ['drop', 'prod']
dstu = ['dust', 'stud']
aelr = ['earl', 'real']
aest = ['east', 'eats', 'sate', 'seat', 'seta', 'teas']
eels = ['eels', 'else', 'lees', 'lese']
egos = ['egos', 'goes']
eeks = ['ekes', 'seek']
ekls = ['elks', 'leks']
eimr = ['emir', 'mire', 'rime']
empt = ['empt', 'temp']
enos = ['eons', 'noes', 'nose', 'ones']
egrs = ['ergs', 'serg']
einr = ['erin', 'rein']
erst = ['erst', 'rest']
ceht = ['etch', 'tech']
eilv = ['evil', 'levi', 'live', 'veil', 'vile']
eesx = ['exes', 'sexe']
afil = ['fail', 'fila']
aflx = ['falx', 'flax']
afst = ['fast', 'fats']
aftu = ['faut', 'tufa']
eeft = ['feet', 'fete']
eflo = ['felo', 'floe']
effi = ['fief', 'fife']
fist = ['fist', 'fits', 'sift']
filt = ['flit', 'lift']
flow = ['flow', 'fowl', 'wolf']
aflo = ['foal', 'loaf']
fmor = ['form', 'from']
eefr = ['free', 'reef']
aegl = ['gael', 'gale']
agms = ['gams', 'mags']
aglo = ['gaol', 'goal']
agps = ['gaps', 'gasp']
agry = ['gary', 'gray']
aglu = ['gaul', 'gual']
gins = ['gins', 'sign', 'sing']
girt = ['girt', 'grit', 'trig']
agnw = ['gnaw', 'wang']
agot = ['goat', 'toga']
ghos = ['gosh', 'hogs']
egry = ['grey', 'gyre']
gipr = ['grip', 'prig']
gmsu = ['gums', 'mugs', 'smug']
ghsu = ['gush', 'hugs']
adeh = ['hade', 'head']
aehl = ['hale', 'heal']
ahms = ['hams', 'mash', 'sham']
ahhs = ['hash', 'shah']
aeht = ['hate', 'heat']
ahsw = ['haws', 'shaw', 'wash']
ehms = ['hems', 'mesh']
ehnw = ['hewn', 'when']
dehi = ['hide', 'hied']
hint = ['hint', 'thin']
hist = ['hist', 'hits', 'this']
dhos = ['hods', 'shod']
hoop = ['hoop', 'pooh']
hors = ['hors', 'rosh']
hmsu = ['hums', 'mush']
hrtu = ['hurt', 'ruth', 'thur']
ikls = ['ilks', 'silk']
illy = ['illy', 'lily']
ikns = ['inks', 'sink', 'skin']
aips = ['ipsa', 'pais', 'pisa']
ainr = ['iran', 'rain', 'rani']
ikrs = ['irks', 'risk']
imss = ['isms', 'miss']
airu = ['iura', 'uria']
ejst = ['jest', 'jets']
aekl = ['kale', 'lake', 'leak']
akns = ['kans', 'sank']
aekt = ['kate', 'take', 'teak']
eekl = ['keel', 'leek']
eekp = ['keep', 'peek']
ekot = ['keto', 'toke']
ikno = ['kino', 'oink']
ikss = ['kiss', 'skis']
akln = ['klan', 'lank']
aklo = ['kola', 'okla']
ailn = ['lain', 'nail']
aelm = ['lame', 'lema', 'male', 'meal']
alst = ['last', 'lats', 'salt', 'slat']
aelv = ['lave', 'vale', 'veal', 'vela']
aelz = ['laze', 'zeal']
eelr = ['leer', 'reel']
elos = ['leos', 'lose', 'oles', 'sloe', 'sole']
delw = ['lewd', 'weld']
eiln = ['lien', 'line', 'nile']
ailm = ['lima', 'mail', 'mali']
ilmo = ['limo', 'moil']
ilps = ['lips', 'lisp', 'slip']
ilst = ['list', 'silt', 'slit']
almo = ['loam', 'malo']
eglo = ['loge', 'ogle']
lnoo = ['loon', 'nolo']
loot = ['loot', 'tool']
lops = ['lops', 'pols', 'slop']
lost = ['lost', 'lots', 'slot']
losw = ['lows', 'owls', 'slow']
elsu = ['lues', 'slue']
lmpu = ['lump', 'plum']
elsy = ['lyes', 'lyse']
elry = ['lyre', 'rely']
amny = ['many', 'myna']
amrt = ['mart', 'tram']
aemt = ['mate', 'meat', 'tame', 'team']
amsy = ['mays', 'yams']
eemt = ['meet', 'mete', 'teem']
emst = ['mets', 'stem']
ilms = ['mils', 'slim']
amno = ['moan', 'noma', 'oman']
mnos = ['mons', 'noms']
emop = ['mope', 'poem']
emor = ['more', 'orem', 'rome']
most = ['most', 'mots', 'toms']
mssu = ['muss', 'sums']
agns = ['nags', 'sang', 'snag']
anps = ['naps', 'pans', 'snap', 'span']
anot = ['nato', 'nota']
enno = ['neon', 'none']
enor = ['nero', 'reno']
einv = ['nevi', 'vein', 'vine']
entw = ['newt', 'went']
enop = ['nope', 'open', 'peon', 'pone']
nstu = ['nuts', 'stun']
akos = ['oaks', 'soak']
emos = ['oems', 'some']
ekoy = ['okey', 'yoke']
opst = ['opts', 'post', 'pots', 'spot', 'stop', 'tops']
ador = ['orad', 'road']
hort = ['orth', 'thor']
orsu = ['ours', 'rous', 'sour']
alov = ['oval', 'vola']
diov = ['ovid', 'void']
nosw = ['owns', 'snow', 'sown']
ailp = ['pail', 'pial']
aipr = ['pair', 'pari']
aprs = ['pars', 'raps', 'rasp', 'spar']
aops = ['paso', 'sapo', 'soap']
apst = ['past', 'pats', 'ptas', 'spat', 'taps']
apsw = ['paws', 'swap', 'wasp']
eelp = ['peel', 'pele']
epru = ['peru', 'pure']
epst = ['pest', 'pets', 'sept', 'step']
eipr = ['pier', 'ripe']
ipsu = ['pius', 'puis']
lopy = ['ploy', 'poly']
eopr = ['pore', 'rope']
oprt = ['port', 'prot', 'trop']
opsw = ['pows', 'swop']
eprs = ['pres', 'reps', 'resp']
mopr = ['prom', 'romp']
pssu = ['puss', 'sups']
aimr = ['rami', 'rima']
aerr = ['rare', 'rear']
arsy = ['rays', 'ryas']
efrs = ['refs', 'serf']
eert = ['rete', 'tree']
ersv = ['revs', 'serv']
iort = ['riot', 'tori', 'trio']
aort = ['rota', 'taro']
orst = ['rots', 'sort']
deru = ['rude', 'rued']
nrtu = ['runt', 'turn']
aesv = ['save', 'vase']
eist = ['site', 'ties']
eisw = ['siwe', 'wise']
osst = ['sots', 'toss']
agst = ['stag', 'tags']
estt = ['stet', 'test']
ostw = ['stow', 'tows', 'twos']
estu = ['suet', 'tues']
arsu = ['sura', 'ursa']
agsw = ['swag', 'wags']
aswy = ['sway', 'ways', 'yaws']
gisw = ['swig', 'wigs']
oott = ['toot', 'toto']
orty = ['tory', 'troy', 'tyro']
adev = ['vade', 'veda']
astv = ['vast', 'vats']
eotv = ['veto', 'vote']
eivw = ['view', 'wive']
aelw = ['wale', 'weal']
aprw = ['warp', 'wrap']
eirw = ['weir', 'wire']
abbes = ['abbes', 'babes']
abest = ['abets', 'baste', 'bates', 'beast', 'beats', 'betas', 'tabes']
abdeo = ['abode', 'adobe']
abrsu = ['abrus', 'bursa']
abstu = ['abuts', 'tabus', 'tubas']
acehs = ['aches', 'chase']
acems = ['acmes', 'maces']
acens = ['acnes', 'canes']
acdet = ['acted', 'cadet', 'ectad']
acstu = ['actus', 'scuta']
addel = ['addle', 'laded']
adeps = ['adeps', 'spade']
aadmn = ['adman', 'damna']
adnor = ['adorn', 'radon']
aeops = ['aesop', 'psoae']
aefrt = ['after', 'freta']
aeggr = ['agger', 'gager']
agnsu = ['agnus', 'angus']
aegsu = ['agues', 'usage']
adeir = ['aider', 'aired', 'redia']
adeil = ['ailed', 'ideal']
aeimr = ['aimer', 'marie', 'ramie', 'rimae']
aknor = ['akron', 'koran', 'krona']
adeln = ['alden', 'eland', 'laden']
aeltu = ['aleut', 'lutea']
aagll = ['algal', 'galla']
agiln = ['algin', 'align', 'ligan', 'ligna']
aceil = ['alice', 'ileac']
aeilv = ['alive', 'alvei']
alloy = ['alloy', 'loyal']
aglno = ['along', 'anglo', 'lagon', 'logan']
abemr = ['amber', 'bream']
aeilm = ['ameli', 'email']
aemns = ['amens', 'manes', 'manse', 'means', 'mensa', 'names']
aeimn = ['amine', 'maine']
agmno = ['among', 'mango']
almpy = ['amply', 'palmy']
aegln = ['angel', 'angle', 'genal', 'glean', 'lange']
agnry = ['angry', 'rangy']
ahkns = ['ankhs', 'hanks', 'khans', 'shank']
amnnu = ['annum', 'unman']
adent = ['anted', 'dante', 'entad']
ainst = ['antis', 'saint', 'satin', 'stain']
aaenp = ['apnea', 'paean']
ailpr = ['april', 'pilar']
aeprt = ['apter', 'parte', 'pater', 'prate', 'taper']
aabrs = ['arabs', 'sabra']
aagrs = ['argas', 'ragas']
agort = ['argot', 'gator', 'grato', 'groat']
ademr = ['armed', 'derma', 'dream']
alory = ['aroyl', 'royal']
anors = ['arson', 'sonar']
acost = ['ascot', 'coast', 'coats', 'costa', 'tacos']
aehrs = ['asher', 'hares', 'hears', 'rheas', 'share', 'shear']
aeksw = ['askew', 'wakes']
acips = ['aspic', 'picas', 'scapi', 'spica']
aerst = ['aster', 'rates', 'stare', 'tares', 'tears', 'teras']
amost = ['atoms', 'moats', 'stoma']
aairt = ['atria', 'riata', 'tiara']
acitt = ['attic', 'tacit']
aciru = ['auric', 'curia']
aersv = ['avers', 'raves', 'saver', 'versa']
adenw = ['awned', 'waned']
anosx = ['axons', 'saxon']
abegl = ['bagel', 'gable']
abils = ['bails', 'basil']
abekr = ['baker', 'brake', 'break']
abdel = ['baled', 'blade']
ablms = ['balms', 'lambs']
abens = ['banes', 'beans']
abder = ['bared', 'beard', 'bread', 'debar']
abcir = ['baric', 'rabic']
abdes = ['based', 'beads']
abiss = ['basis', 'bassi']
abeht = ['bathe', 'habet']
abems = ['beams', 'bemas']
bdeim = ['bedim', 'imbed']
begin = ['begin', 'being', 'binge']
below = ['below', 'bowel', 'elbow']
abily = ['bialy', 'libya']
beins = ['biens', 'ibsen']
bdirs = ['birds', 'dribs']
beirt = ['biter', 'tiber', 'tribe']
beelp = ['bleep', 'plebe']
blosw = ['blows', 'bowls']
belsu = ['blues', 'lubes']
abdor = ['board', 'broad']
beors = ['boers', 'bores', 'robes', 'sober']
blosu = ['bolus', 'lobus']
bnoos = ['bonos', 'boons', 'boson']
bmoos = ['booms', 'bosom']
boost = ['boost', 'boots']
abgrs = ['brags', 'garbs', 'grabs']
aberv = ['brave', 'verba']
befir = ['brief', 'fiber', 'fibre']
bmoor = ['bromo', 'broom']
bceru = ['bruce', 'cuber']
bnrtu = ['brunt', 'burnt']
bertu = ['brute', 'buret', 'rebut', 'tuber']
beglu = ['bugle', 'bulge']
abmru = ['burma', 'rumba', 'umbra']
bsstu = ['busts', 'stubs']
acdeg = ['cadge', 'caged']
acefs = ['cafes', 'faces']
acinr = ['cairn', 'rican']
acill = ['calli', 'lilac']
aclor = ['calor', 'carlo', 'carol', 'coral']
acenr = ['caner', 'carne', 'crane', 'crena', 'nacre']
acnny = ['canny', 'nancy']
acnst = ['cants', 'scant']
acepr = ['caper', 'carpe', 'pacer', 'recap']
acerr = ['carer', 'racer']
acmor = ['carom', 'coram', 'macro']
acerv = ['carve', 'crave']
ackss = ['casks', 'sacks']
achty = ['cathy', 'yacht']
aaclv = ['caval', 'clava']
cdeer = ['ceder', 'cered', 'creed']
achin = ['chain', 'china']
achrs = ['chars', 'crash']
acehp = ['cheap', 'peach']
cehrt = ['chert', 'retch']
cehim = ['chime', 'hemic']
chior = ['choir', 'ichor']
chlru = ['churl', 'lurch']
aciil = ['cilia', 'iliac']
ceitv = ['civet', 'evict']
acdls = ['clads', 'scald']
aclps = ['claps', 'clasp', 'scalp']
aceln = ['clean', 'lance']
acelt = ['cleat', 'eclat', 'ectal']
clost = ['clots', 'colts']
aclos = ['coals', 'colas']
cdeos = ['codes', 'coeds']
acllo = ['colla', 'local']
cenos = ['cones', 'scone']
coops = ['coops', 'scoop']
ceops = ['copes', 'copse', 'scope']
cdors = ['cords', 'scrod']
ckors = ['corks', 'rocks']
cnors = ['corns', 'scorn']
coprs = ['corps', 'crops']
copsu = ['coups', 'pocus']
closw = ['cowls', 'scowl']
acrss = ['crass', 'scars']
ceepr = ['creep', 'crepe']
cersw = ['crews', 'screw']
ceimr = ['crime', 'merci']
cderu = ['crude', 'cured']
certu = ['cruet', 'curet', 'cuter', 'eruct', 'truce']
crstu = ['crust', 'curst']
cllsu = ['culls', 'scull']
cdipu = ['cupid', 'pudic']
cerru = ['curer', 'recur']
cistu = ['cutis', 'ictus']
adels = ['dales', 'deals', 'lades', 'leads']
admno = ['damno', 'monad', 'nomad']
aders = ['dares', 'dears', 'rased', 'reads']
adest = ['dates', 'sated', 'stead']
adnsw = ['dawns', 'wands']
adeht = ['death', 'hated']
ddeit = ['dedit', 'tided']
deeps = ['deeps', 'pedes', 'speed']
deefr = ['defer', 'freed']
deims = ['deism', 'dimes']
deils = ['delis', 'idles', 'sidle', 'slide']
demno = ['demon', 'monde']
deimn = ['denim', 'mined']
denst = ['dents', 'tends']
deesx = ['desex', 'sexed']
cdeeu = ['deuce', 'educe']
dehlo = ['dhole', 'holed']
degio = ['diego', 'dogie']
deiks = ['dikes', 'skied']
adinr = ['dinar', 'drain', 'nadir']
dgino = ['dingo', 'doing']
deios = ['diose', 'idose']
degir = ['dirge', 'ridge']
dikss = ['disks', 'skids']
deirv = ['diver', 'drive', 'rived', 'verdi']
deors = ['doers', 'doser']
delos = ['doles', 'lodes', 'soled']
dmoos = ['dooms', 'moods', 'sodom']
deopr = ['doper', 'pored', 'roped']
diors = ['doris', 'dorsi']
deorv = ['dover', 'drove', 'roved']
deorw = ['dower', 'rowed']
deosw = ['dowse', 'sowed']
adgrs = ['drags', 'grads']
adepr = ['drape', 'padre', 'pared', 'raped']
adrsy = ['drays', 'yards']
deirs = ['dries', 'rides', 'sired']
depru = ['drupe', 'duper', 'prude']
delsu = ['duels', 'slued']
depsu = ['dupes', 'pseud']
dstuy = ['dusty', 'study']
aelrs = ['earls', 'lares', 'laser', 'reals']
aenrs = ['earns', 'nares', 'nears', 'rnase', 'saner', 'snare']
aeels = ['easel', 'lease']
adeev = ['eaved', 'evade']
deegr = ['edger', 'greed']
eegst = ['egest', 'geste']
eegin = ['eigne', 'genie']
eelrv = ['elver', 'lever', 'revel']
eimrs = ['emirs', 'mires', 'miser']
denow = ['endow', 'owned']
elnor = ['enrol', 'loner']
eenrt = ['enter', 'entre']
ceips = ['epics', 'spice']
eipqu = ['equip', 'pique']
eerst = ['ester', 'reset', 'steer', 'teres', 'terse', 'trees']
eehlt = ['ethel', 'lethe']
ehost = ['ethos', 'those']
eensv = ['evens', 'seven']
eersw = ['ewers', 'sewer']
eistx = ['exist', 'exits', 'texis']
aertx = ['extra', 'taxer']
afils = ['fails', 'falsi']
aefkr = ['faker', 'freak']
aefrs = ['fares', 'fears', 'safer']
afltu = ['fault', 'flatu']
eefls = ['feels', 'flees']
aeflr = ['feral', 'flare']
efort = ['fetor', 'forte']
defil = ['fidel', 'field', 'filed', 'flied']
defin = ['fiend', 'fined']
efilr = ['filer', 'flier', 'lifer', 'rifle']
efinr = ['finer', 'infer']
efirr = ['firer', 'frier']
first = ['first', 'rifts']
efhls = ['flesh', 'shelf']
fglos = ['flogs', 'golfs']
flosw = ['flows', 'fowls']
aflos = ['foals', 'loafs']
fhort = ['forth', 'froth']
afoss = ['fossa', 'sofas']
eefrr = ['freer', 'refer']
adgsu = ['gadus', 'gauds']
agins = ['gains', 'signa']
acgim = ['gamic', 'magic']
aglos = ['gaols', 'goals']
aegpr = ['gaper', 'grape', 'pager']
aegss = ['gases', 'sages']
agntu = ['gaunt', 'tunga']
degil = ['gelid', 'glide']
eegnr = ['genre', 'green']
dgirs = ['girds', 'grids']
girst = ['girts', 'grist', 'grits', 'trigs']
aeglr = ['glare', 'lager', 'large', 'regal']
gloss = ['gloss', 'slogs']
agost = ['goats', 'togas']
egors = ['gores', 'gorse', 'ogres']
agprs = ['grasp', 'sprag']
ginrs = ['grins', 'rings']
gnorw = ['grown', 'wrong']
glpsu = ['gulps', 'plugs']
achks = ['hacks', 'shack']
afhst = ['hafts', 'shaft']
aehls = ['hales', 'heals', 'leash', 'shale']
ahlos = ['halos', 'shoal']
adhny = ['handy', 'haydn']
adhry = ['hardy', 'hydra']
ahmrs = ['harms', 'marsh']
aehst = ['haste', 'hates', 'heats']
ahntu = ['haunt', 'utahn']
adehy = ['hayed', 'heady']
ehirs = ['heirs', 'hires', 'shier', 'shire']
ehlls = ['hells', 'shell']
aehpr = ['hepar', 'raphe']
eehrs = ['heres', 'sheer']
ehors = ['heros', 'hoers', 'horse', 'shoer', 'shore']
dehir = ['hider', 'hired']
ehiks = ['hikes', 'sheik']
eghin = ['hinge', 'neigh']
chkos = ['hocks', 'shock']
ehloy = ['holey', 'hoyle']
hkoos = ['hooks', 'shook']
hoost = ['hoots', 'shoot', 'sooth']
dehor = ['horde', 'rhode']
dehos = ['hosed', 'shoed']
hosst = ['hosts', 'shots']
hnstu = ['hunts', 'shunt']
diimo = ['idiom', 'imido']
dilos = ['idols', 'lidos', 'solid']
aimms = ['imams', 'maims', 'miasm']
eimpr = ['imper', 'prime']
cinru = ['incur', 'runic']
einrt = ['inert', 'inter', 'niter', 'nitre']
inops = ['inops', 'opsin', 'spino']
ainrt = ['intra', 'train']
aiost = ['iotas', 'ostia']
inors = ['irons', 'rosin']
eilst = ['islet', 'lites', 'stile', 'tiles']
ajnsu = ['janus', 'juans']
jostu = ['joust', 'justo']
aekms = ['kames', 'makes']
akosy = ['kayos', 'okays']
eekls = ['keels', 'leeks', 'sleek']
eekps = ['keeps', 'peeks']
iklls = ['kills', 'skill']
egikl = ['kleig', 'klieg']
adekn = ['knead', 'naked']
knost = ['knots', 'tonks']
kmsuy = ['kumys', 'musky']
ablor = ['labor', 'lobar']
ackls = ['lacks', 'slack']
adelm = ['lamed', 'medal']
aelms = ['lames', 'males', 'meals', 'mesal', 'salem']
aelns = ['lanes', 'leans']
ailps = ['lapis', 'pails']
aelps = ['lapse', 'leaps', 'pales', 'peals', 'pleas', 'sepal']
alstu = ['latus', 'talus', 'tulsa']
aelsv = ['laves', 'salve', 'slave', 'vales', 'valse']
aelrx = ['laxer', 'relax']
aelnr = ['learn', 'renal']
eelrs = ['leers', 'reels']
eilnn = ['lenin', 'linen']
aelpr = ['lepra', 'paler', 'pearl']
eilnv = ['levin', 'liven']
cikls = ['licks', 'slick']
eiltu = ['lieut', 'utile']
illst = ['lilts', 'still', 'tills']
eilms = ['limes', 'miles', 'slime', 'smile']
adiln = ['linda', 'nidal']
ilnos = ['lions', 'loins']
ilsst = ['lists', 'silts', 'slits']
iilst = ['litis', 'stili']
alnos = ['loans', 'salon']
deglo = ['lodge', 'ogled']
eglos = ['loges', 'ogles']
lnoos = ['loons', 'solon']
loost = ['loots', 'stool', 'tools']
elops = ['lopes', 'poles', 'slope']
lostu = ['lotus', 'louts']
elosv = ['loves', 'solve', 'voles']
fflsu = ['luffs', 'sluff']
lmpuy = ['lumpy', 'plumy']
glnsu = ['lungs', 'slung']
elrsu = ['lures', 'rules']
aelsy = ['lyase', 'sealy']
alssy = ['lyssa', 'slays']
agims = ['magis', 'sigma']
aekmr = ['maker', 'marek', 'remak']
almsu = ['malus', 'mauls']
aimor = ['maori', 'moria']
amrst = ['marts', 'smart', 'trams']
aemss = ['masse', 'mesas', 'seams']
aemrt = ['mater', 'metra', 'tamer']
amory = ['mayor', 'moray']
eemst = ['meets', 'metes', 'teems']
eimrt = ['merit', 'miter', 'remit', 'timer']
emnos = ['meson', 'omens']
dimos = ['misdo', 'modis']
ckmos = ['mocks', 'smock']
almor = ['molar', 'moral']
moors = ['moors', 'rooms']
amors = ['moras', 'roams']
mnors = ['morns', 'norms']
lmotu = ['moult', 'multo']
eimox = ['moxie', 'oxime']
acmsu = ['musca', 'sumac']
aeinv = ['naevi', 'naive']
ainrs = ['naris', 'rains', 'ranis', 'sarin']
aelnv = ['navel', 'venal']
aelnp = ['nepal', 'panel', 'penal', 'plane', 'plena']
denrs = ['nerds', 'rends']
einrv = ['nervi', 'riven']
eenrw = ['newer', 'renew']
ghint = ['night', 'thing']
belno = ['nobel', 'noble']
dnosu = ['nodus', 'sound']
hnort = ['north', 'thorn']
denot = ['noted', 'tendo', 'toned']
enort = ['notre', 'tenor', 'toner']
enrsu = ['nurse', 'runes']
ahost = ['oaths', 'shoat']
eilor = ['oiler', 'oriel']
aamos = ['omasa', 'samoa']
alors = ['orals', 'solar']
ehort = ['other', 'throe']
ghotu = ['ought', 'tough']
alosv = ['ovals', 'salvo']
eortv = ['overt', 'trove', 'voter']
aenoz = ['ozena', 'zonae']
aiprs = ['pairs', 'paris']
allps = ['palls', 'spall']
ainnp = ['panni', 'pinna']
aeprs = ['pares', 'parse', 'pears', 'rapes', 'reaps', 'spare', 'spear']
alopr = ['parol', 'polar', 'proal']
aprst = ['parts', 'sprat', 'strap', 'traps']
aepst = ['paste', 'pates', 'septa', 'spate', 'tapes']
apsty = ['pasty', 'patsy']
aoprv = ['pavor', 'vapor']
aepry = ['payer', 'repay']
cekps = ['pecks', 'speck']
eelps = ['peels', 'sleep', 'speel']
eeprs = ['peers', 'spree']
denps = ['pends', 'spend']
eipps = ['pepsi', 'pipes']
eopss = ['pesos', 'poses', 'posse']
eiprt = ['petri', 'tripe']
cikps = ['picks', 'spick']
deilp = ['piled', 'plied']
illps = ['pills', 'spill']
alpst = ['plats', 'splat']
loptu = ['pluto', 'poult']
elopr = ['poler', 'prole']
oprst = ['ports', 'sport', 'strop']
opsst = ['posts', 'spots', 'stops']
amprs = ['prams', 'ramps']
eprxy = ['prexy', 'pyrex']
deipr = ['pride', 'pried']
iprst = ['prist', 'strip', 'trips']
moprs = ['proms', 'romps']
knpsu = ['punks', 'spunk']
lprsu = ['purls', 'slurp']
adqsu = ['quads', 'squad']
eiqtu = ['quiet', 'quite']
eoqtu = ['quote', 'toque']
aprss = ['rasps', 'spars']
adery = ['rayed', 'ready']
ceirt = ['recti', 'trice']
deers = ['reeds', 'seder']
einrs = ['reins', 'resin', 'rinse', 'risen', 'siren']
einpr = ['repin', 'ripen']
ersst = ['rests', 'tress']
ehinr = ['rhein', 'rhine']
iorst = ['riots', 'tiros', 'torsi', 'trios', 'trois']
eirst = ['rites', 'tiers', 'tires', 'tries']
eirsv = ['rives', 'vires']
egoru = ['rogue', 'rouge']
eorss = ['roses', 'sores']
orstu = ['roust', 'routs', 'torus', 'tours']
erssu = ['ruses', 'russe', 'suers', 'users']
rstuy = ['rusty', 'yurts']
ailss = ['sails', 'sisal']
aanst = ['santa', 'satan']
adesv = ['saved', 'vades']
adesw = ['sawed', 'wades']
aersy = ['sayer', 'years']
aeest = ['setae', 'tease']
deesw = ['sewed', 'swede', 'weeds']
eehst = ['sheet', 'these']
hostu = ['shout', 'south']
iloss = ['silos', 'soils']
einsw = ['sinew', 'swine', 'wines']
eisst = ['sites', 'sties']
eelst = ['sleet', 'steel']
aknsy = ['snaky', 'yanks']
inpss = ['snips', 'spins']
nostu = ['snout', 'tonus']
oostt = ['sotto', 'toots']
ackst = ['stack', 'tacks']
ampst = ['stamp', 'tamps']
arsst = ['stars', 'tsars']
aestt = ['state', 'taste', 'teats']
cikst = ['stick', 'ticks']
ilstt = ['stilt', 'tilts']
aostt = ['stoat', 'toast']
orsty = ['story', 'tyros']
eostv = ['stove', 'votes']
erstw = ['strew', 'wrest']
ckstu = ['stuck', 'tucks']
instu = ['suint', 'tunis', 'units']
aegsw = ['swage', 'wages']
amrsw = ['swarm', 'warms']
aestw = ['sweat', 'tawse', 'waste']
ellsw = ['swell', 'wells']
ginsw = ['swing', 'wings']
dorsw = ['sword', 'words']
aintt = ['taint', 'titan']
aestx = ['taxes', 'texas']
aeint = ['tenia', 'tinea']
ehstw = ['thews', 'whets']
deirt = ['tired', 'tried']
adoty = ['toady', 'today']
orstt = ['torts', 'trots']
nostw = ['towns', 'wonts']
orttu = ['trout', 'tutor']
abnru = ['unbar', 'urban']
ilntu = ['unlit', 'until']
alorv = ['valor', 'volar']
eisvw = ['views', 'wives']
ciinv = ['vinci', 'vinic']
aistw = ['waist', 'waits']
aensw = ['wanes', 'weans']
apswy = ['waspy', 'yawps']
eirsw = ['weirs', 'wires', 'wiser']
deilw = ['wield', 'wiled']
irstw = ['wrist', 'writs']
abelst = ['ablest', 'bleats', 'stable', 'tables']
aabdor = ['aboard', 'aborad', 'abroad']
aborst = ['aborts', 'tabors']
abersu = ['abuser', 'bursae']
acelot = ['acetol', 'locate']
acdily = ['acidly', 'acidyl']
acnors = ['acorns', 'carson']
acorss = ['across', 'oscars']
acorst = ['actors', 'castor', 'castro', 'scrota']
adders = ['adders', 'dreads', 'sadder']
adeest = ['adeste', 'seated', 'sedate', 'teased']
adeint = ['adient', 'detain']
adimst = ['admits', 'amidst']
adeorr = ['adorer', 'roader', 'roared']
abdors = ['adsorb', 'boards', 'broads']
adeisv = ['advise', 'visaed']
aaffir = ['affair', 'raffia']
aacgir = ['agaric', 'garcia']
aegims = ['ageism', 'images']
adeegr = ['agreed', 'geared']
aeegrs = ['agrees', 'grease']
adeimn = ['aidmen', 'maiden', 'median', 'medina']
aeirrs = ['airers', 'ariser', 'raiser', 'sierra']
aeimnr = ['airmen', 'marine', 'remain']
abdelo = ['albedo', 'doable']
aelrst = ['alerts', 'alters', 'estral', 'laster', 'salter', 'slater', 'staler']
aeilno = ['alieno', 'eolian']
agilns = ['aligns', 'signal']
aeegll = ['allege', 'legale']
allosw = ['allows', 'sallow']
adlmno = ['almond', 'dolman']
aeilnp = ['alpine', 'penial', 'pineal']
aalrst = ['altars', 'astral', 'tarsal']
aalmnu = ['alumna', 'manual']
aelsuv = ['alveus', 'avulse', 'values']
abelmr = ['ambler', 'blamer', 'marble', 'ramble']
aelmsu = ['amelus', 'samuel']
aceemr = ['amerce', 'raceme']
aimnno = ['amnion', 'nomina']
almpsu = ['ampuls', 'palmus']
ademsu = ['amused', 'medusa']
aademn = ['anadem', 'maenad']
aceinn = ['ancien', 'canine']
aadinr = ['andira', 'radian']
aceimn = ['anemic', 'cinema', 'iceman']
aegnrs = ['angers', 'ganser', 'ranges']
aeglnr = ['angler', 'regnal']
agilnu = ['anguli', 'lingua']
ainnos = ['anions', 'nasion']
aaegln = ['anlage', 'galena', 'lagena']
aemnor = ['anomer', 'enamor', 'monera', 'normae']
aehnrt = ['anther', 'tehran', 'thenar']
amnrtu = ['antrum', 'truman']
adenpp = ['append', 'dappen', 'napped']
acehrs = ['arches', 'casher', 'chaser', 'eschar', 'search']
acdekr = ['arcked', 'racked']
aaenrs = ['arenas', 'rnaase']
agorst = ['argots', 'groats']
aeinrs = ['arisen', 'arsine', 'resina']
aemrrs = ['armers', 'rearms']
aimprt = ['armpit', 'impart']
aenrrt = ['arrent', 'errant', 'ranter']
aerrty = ['artery', 'rarety']
acdens = ['ascend', 'dances']
acosst = ['ascots', 'coasts']
aehors = ['ashore', 'hoarse']
adeiss = ['asides', 'daises']
aeelps = ['asleep', 'elapse', 'please']
aeiprs = ['aspire', 'paries', 'persia', 'praise', 'spirea']
aersst = ['assert', 'asters', 'stares']
aessst = ['assets', 'stases']
aorsst = ['assort', 'roasts']
aesttu = ['astute', 'statue']
acimot = ['atomic', 'matico']
aenort = ['atoner', 'ornate']
aailrt = ['atrial', 'lariat']
acistt = ['attics', 'static']
aeegnv = ['avenge', 'geneva']
aerstv = ['averts', 'starve', 'vaster']
aceotv = ['avocet', 'octave']
abdegr = ['badger', 'barged', 'garbed']
abeggr = ['bagger', 'beggar']
abdeit = ['baited', 'debita']
abekrs = ['bakers', 'brakes', 'breaks']
abeeln = ['baleen', 'enable']
abegln = ['bangle', 'bengal']
abbelr = ['barbel', 'rabble']
aberst = ['barest', 'breast']
abnory = ['barony', 'baryon']
abinos = ['basion', 'bonsai']
abehrt = ['bather', 'breath']
abelrw = ['bawler', 'warble']
abeert = ['beater', 'berate', 'rebate']
begins = ['begins', 'beings', 'binges']
bdeeil = ['belied', 'edible']
bemoss = ['besoms', 'emboss']
bdeist = ['bidets', 'debits']
abinry = ['binary', 'brainy']
bginos = ['bingos', 'gibson']
beelps = ['bleeps', 'plebes']
belstu = ['bluest', 'bustle', 'sublet', 'subtle']
abeort = ['boater', 'borate']
beilor = ['boiler', 'reboil']
benorz = ['bonzer', 'bronze']
bginor = ['boring', 'robing']
bnorsu = ['bourns', 'suborn']
beorsw = ['bowers', 'browse']
abeirs = ['braise', 'rabies', 'serbia']
beirsv = ['brevis', 'verbis']
bbeirr = ['briber', 'ribber']
bdeirs = ['brides', 'debris']
bmoors = ['bromos', 'brooms']
beirsu = ['bruise', 'buries', 'busier', 'rubies']
bdegsu = ['budges', 'debugs']
bdeglu = ['bugled', 'bulged']
beglsu = ['bugles', 'bulges']
bdenru = ['burden', 'burned', 'unbred']
accdeh = ['cached', 'chaced']
acdegr = ['cadger', 'graced']
acegrs = ['cagers', 'graces']
acinrs = ['cairns', 'ricans']
acellr = ['caller', 'cellar', 'recall']
acelmr = ['calmer', 'marcel']
acdemp = ['camped', 'decamp']
acdnor = ['candor', 'dacron']
acnnot = ['cannot', 'canton']
acenos = ['canoes', 'oceans']
acenrt = ['canter', 'centra', 'nectar', 'recant', 'trance']
aaclnu = ['canula', 'lacuna']
aceprs = ['capers', 'casper', 'pacers', 'recaps', 'scrape', 'spacer']
acpstu = ['captus', 'catsup']
acerrs = ['carers', 'racers']
acerst = ['carets', 'cartes', 'caster', 'caters', 'crates', 'reacts', 'recast', 'traces']
acmors = ['caroms', 'macros']
acelpr = ['carpel', 'parcel', 'placer']
acorrt = ['carrot', 'trocar']
acelrt = ['cartel', 'claret', 'rectal']
acderv = ['carved', 'craved']
acersv = ['carves', 'craves']
acdehs = ['cashed', 'chased']
acelst = ['castle', 'cleats']
acdesu = ['caused', 'sauced']
acessu = ['causes', 'sauces']
acenrv = ['cavern', 'craven']
acilsv = ['cavils', 'slavic']
cdeers = ['ceders', 'creeds']
ceenrs = ['censer', 'screen', 'secern']
ceenrt = ['center', 'recent']
ccersu = ['cercus', 'cruces']
ceginr = ['cering', 'cringe']
ceimsu = ['cesium', 'miscue']
achirs = ['chairs', 'rachis']
achkly = ['chalky', 'hackly']
achrst = ['charts', 'starch']
ceehps = ['cheeps', 'speech']
cchiks = ['chicks', 'schick']
cdehir = ['chider', 'herdic']
cehins = ['chines', 'inches', 'niches']
cdehko = ['choked', 'hocked']
acehor = ['chorea', 'horace']
cdeirs = ['ciders', 'dicers']
cirrsu = ['cirrus', 'cruris']
cciirt = ['citric', 'critic']
cirstu = ['citrus', 'rictus', 'rustic']
aclpss = ['clasps', 'scalps']
acelrs = ['clears', 'lacers', 'scaler', 'sclera']
ceilnt = ['client', 'lectin']
clnosu = ['clonus', 'consul']
clostu = ['clouts', 'locust']
ceimns = ['cnemis', 'minces']
cehior = ['coheir', 'heroic']
ceilor = ['coiler', 'recoil']
ceillo = ['collie', 'ocelli']
bcemor = ['comber', 'recomb']
cgimno = ['coming', 'gnomic']
acmost = ['comsat', 'mascot']
cekoor = ['cooker', 'recook']
cdeoop = ['cooped', 'opcode']
aclopu = ['copula', 'cupola']
ceorrs = ['corers', 'scorer']
cekorr = ['corker', 'rocker']
ceorst = ['corset', 'escort', 'rectos', 'sector']
cnostu = ['counts', 'tucson']
ceortv = ['covert', 'vector']
ceorsw = ['cowers', 'escrow']
acdelr = ['cradle', 'reclad']
aclrsw = ['crawls', 'scrawl']
acemrs = ['creams', 'scream']
ceeprs = ['creeps', 'crepes']
cimprs = ['crimps', 'scrimp']
ccorsu = ['crocus', 'occurs', 'succor']
ceirsu = ['cruise', 'curies']
bcistu = ['cubist', 'cubits']
cdelru = ['curdle', 'curled']
cerssu = ['curses', 'cusser']
cffotu = ['cutoff', 'offcut']
adefrt = ['dafter', 'rafted']
addemn = ['damned', 'demand', 'madden']
adelms = ['damsel', 'medals']
addenr = ['dander', 'darned', 'dendra']
adegnr = ['danger', 'gander', 'garden', 'grande', 'ranged']
adeknr = ['danker', 'darken', 'ranked']
adelpp = ['dapple', 'lapped']
adenrr = ['darner', 'errand']
aderrt = ['darter', 'retard', 'retrad', 'tarred', 'trader']
addehs = ['dashed', 'shaded']
adehss = ['dashes', 'shades']
adnstu = ['datsun', 'daunts']
adeefr = ['deafer', 'feared']
adeelr = ['dealer', 'leader']
adeeir = ['dearie', 'rediae']
abdees = ['debase', 'seabed']
cddeei = ['decide', 'deiced']
cddeeu = ['deduce', 'educed']
deelpy = ['deeply', 'yelped']
ddeefn = ['defend', 'fended']
adefry = ['defray', 'frayed']
dehors = ['dehors', 'hordes', 'horsed', 'rhodes', 'shored']
degins = ['deigns', 'design', 'signed', 'singed']
adeelt = ['delate', 'elated']
adelst = ['deltas', 'desalt', 'lasted', 'salted', 'slated', 'staled']
deemot = ['demote', 'emoted']
deeinr = ['denier', 'diener', 'nereid', 'reined']
deinns = ['dennis', 'sinned']
ddeent = ['dented', 'tended']
deinnt = ['dentin', 'indent', 'intend', 'tinned']
deenrv = ['denver', 'nerved', 'vender']
ddeenp = ['depend', 'pended']
deoprt = ['deport', 'ported']
adeilr = ['derail', 'dialer', 'railed', 'redial']
deirrs = ['derris', 'driers', 'riders']
deeirs = ['desire', 'eiders', 'reside']
deestt = ['detest', 'tested']
cdeesu = ['deuces', 'educes', 'seduce']
deeisv = ['devise', 'sieved']
deiorv = ['devoir', 'voider']
deilwy = ['dewily', 'widely']
addeim = ['diadem', 'mediad']
adeipr = ['diaper', 'paired', 'piedra', 'repaid']
dddeil = ['diddle', 'lidded']
deeils = ['diesel', 'elides']
deeirt = ['dieter', 'reedit', 'retied']
deggir = ['digger', 'rigged']
deilmp = ['dimple', 'impled', 'limped']
deinrs = ['diners', 'rinsed', 'snider']
deippr = ['dipper', 'ripped']
degirs = ['dirges', 'ridges']
deinsy = ['disney', 'sidney']
deissu = ['disuse', 'issued']
deirsv = ['divers', 'drives']
dginos = ['doings', 'dosing']
adimno = ['domain', 'domina']
deorss = ['dosers', 'sordes']
deorst = ['doters', 'sorted', 'stored', 'strode']
deossu = ['douses', 'soused']
deorsw = ['dowers', 'dowser', 'drowse']
aadmrs = ['dramas', 'madras']
adeprs = ['drapes', 'padres', 'parsed', 'rasped', 'spared', 'spread']
aderrw = ['drawer', 'redraw', 'reward', 'warder', 'warred']
dllory = ['drolly', 'lordly']
denors = ['drones', 'snored']
denrsu = ['drusen', 'nursed', 'sunder']
deelru = ['dueler', 'eluder']
deffru = ['duffer', 'ruffed']
deistu = ['duties', 'suited']
aeeglt = ['eaglet', 'gelate', 'legate']
adeenr = ['earned', 'endear', 'neared']
aehrst = ['earths', 'haters', 'hearts']
aeelss = ['easels', 'leases']
aeerst = ['easter', 'eaters', 'reseat', 'teaser']
adeems = ['edemas', 'seamed']
deiort = ['editor', 'rioted', 'triode']
aeegst = ['egesta', 'gestae']
eegrst = ['egrets', 'greets']
aeeiln = ['elaine', 'lineae']
ceelst = ['elects', 'select']
egilno = ['eloign', 'legion']
eelrsv = ['elvers', 'levers', 'revels']
eegimr = ['emigre', 'regime']
eemort = ['emoter', 'meteor', 'remote']
aceens = ['encase', 'seance', 'seneca']
deeinv = ['endive', 'envied', 'veined']
deensu = ['endues', 'ensued']
aeemns = ['enemas', 'mensae', 'seamen']
aegmnr = ['engram', 'german', 'manger']
eilnst = ['enlist', 'inlets', 'listen', 'silent', 'tinsel']
eeilns = ['ensile', 'senile']
eenrst = ['enters', 'ernest', 'nester', 'resent', 'tenser']
aenprt = ['entrap', 'parent', 'trepan']
eeinrv = ['envier', 'venire']
eimnos = ['eonism', 'moines', 'monies']
aelqsu = ['equals', 'squeal']
adeers = ['erased', 'seared']
ceerst = ['erects', 'resect', 'secret']
eginrr = ['erring', 'ringer']
eiprst = ['esprit', 'priest', 'ripest', 'sprite', 'stripe', 'tripes']
eersst = ['esters', 'resets', 'steers']
einrst = ['estrin', 'insert', 'inters', 'sterni']
ersstu = ['estrus', 'russet', 'surest']
deeenv = ['evened', 'vendee']
eillvy = ['evilly', 'lively', 'vilely']
eekorv = ['evoker', 'revoke']
ceeptx = ['except', 'expect']
aerstx = ['extras', 'taxers']
acfort = ['factor', 'fracto']
aefkry = ['fakery', 'freaky']
aeflrs = ['falser', 'flares']
aefmrr = ['farmer', 'framer']
aflstu = ['faults', 'flatus']
deeefr = ['feeder', 'reefed']
adeflo = ['feodal', 'foaled', 'loafed']
eeflru = ['ferule', 'refuel']
defgit = ['fidget', 'gifted']
efilst = ['filets', 'itself', 'stifle']
efilrt = ['filter', 'lifter', 'trifle']
efginr = ['finger', 'fringe']
fhirst = ['firths', 'shrift']
aeflor = ['florae', 'loafer']
eflorw = ['flower', 'fowler', 'reflow']
ddefor = ['fodder', 'forded']
efoort = ['foetor', 'footer']
cefors = ['forces', 'fresco']
efgors = ['forges', 'gofers']
defnru = ['freund', 'funder', 'refund']
acflru = ['fulcra', 'furcal']
addegr = ['gadder', 'graded']
aeginr = ['gainer', 'reagin', 'regain', 'regina']
aeglmy = ['gamely', 'gleamy']
aegimr = ['gamier', 'mirage']
adeggn = ['ganged', 'nagged']
agginp = ['gaping', 'paging']
aegnrr = ['garner', 'ranger']
aegrst = ['gaster', 'grates', 'stager']
aegrsz = ['gazers', 'grazes']
eegins = ['genies', 'seeing', 'signee']
adeglr = ['gerald', 'glared']
ghlosu = ['ghouls', 'slough']
ddegil = ['gilded', 'glided']
egginr = ['ginger', 'nigger']
ghirst = ['girths', 'rights']
bgilno = ['globin', 'goblin']
eglorv = ['glover', 'grovel']
aegnrw = ['gnawer', 'wagner']
deglno = ['golden', 'longed']
aginrs = ['grains', 'rasing']
aginrt = ['gratin', 'rating', 'taring']
ginors = ['groins', 'signor']
egorsu = ['grouse', 'rogues', 'rouges', 'rugose']
deggru = ['grudge', 'rugged']
egsstu = ['guests', 'gusset']
deglnu = ['gulden', 'lunged']
adehil = ['hailed', 'halide']
adehlt = ['halted', 'lathed']
adehln = ['handel', 'handle']
aehknr = ['hanker', 'harken']
aehmrs = ['harems', 'masher']
aehlss = ['hassle', 'lashes', 'shales']
ahnstu = ['haunts', 'utahns']
aehrsw = ['hawser', 'rewash', 'washer']
aeehrt = ['heater', 'reheat']
aeehsv = ['heaves', 'sheave']
eeehlr = ['heeler', 'reheel']
ehlost = ['helots', 'hostel', 'hotels']
eehmrs = ['hermes', 'rehems']
eehprs = ['herpes', 'sphere']
eghins = ['hinges', 'neighs']
ehirss = ['hisser', 'shires']
ehirtt = ['hitter', 'tither']
ehoprs = ['hopers', 'posher']
ehorss = ['horses', 'shores']
ehlosv = ['hovels', 'shovel']
eghnru = ['hunger', 'rehung']
hnorsu = ['hurons', 'onrush']
ehlstu = ['hustle', 'sleuth']
adeils = ['ideals', 'ladies', 'sailed']
deilrs = ['idlers', 'slider']
giloos = ['igloos', 'isolog']
eginor = ['ignore', 'region']
eilmps = ['impels', 'simple']
eimptu = ['impute', 'uptime']
deiins = ['indies', 'inside']
dgiinr = ['ingrid', 'riding']
imnost = ['inmost', 'monist']
aeinns = ['insane', 'sienna']
einsst = ['insets', 'steins']
ailnst = ['instal', 'latins', 'stalin']
ilnstu = ['insult', 'sunlit']
deinru = ['inured', 'ruined']
eilsst = ['islets', 'sliest', 'stiles']
aeilrs = ['israel', 'serial']
deiosx = ['ixodes', 'oxides']
adhijs = ['jadish', 'jihads']
eijnor = ['joiner', 'rejoin']
adekoy = ['kayoed', 'okayed']
ddiikv = ['kidvid', 'vidkid']
deikln = ['kindle', 'linked']
eikrst = ['kiters', 'strike']
adekns = ['kneads', 'snaked']
ablmru = ['labrum', 'lumbar', 'umbral']
adgiln = ['lading', 'ligand']
aelmst = ['lamest', 'metals']
agilmn = ['laming', 'malign']
adelps = ['lapsed', 'pedals', 'pleads']
aelpss = ['lapses', 'passel', 'sepals']
aelntt = ['latent', 'talent']
aelrtt = ['latter', 'rattle']
acilru = ['lauric', 'uracil']
aelmny = ['laymen', 'meanly', 'namely']
adeeln = ['leaden', 'leaned']
aeelpr = ['leaper', 'repeal']
aeelrs = ['leaser', 'resale', 'reseal', 'sealer']
deegls = ['ledges', 'sledge']
aeglmn = ['legman', 'mangle']
eelnss = ['lenses', 'lessen']
eelprs = ['lepers', 'repels']
eelrst = ['lester', 'relets']
aelntv = ['levant', 'valent']
deeilv = ['levied', 'veiled']
deelrw = ['lewder', 'reweld', 'welder']
aeilln = ['lienal', 'lineal']
aegils = ['ligase', 'silage']
giilnn = ['lignin', 'lining']
acills = ['lilacs', 'scilla']
aeilnr = ['linear', 'nailer']
eiklnr = ['linker', 'relink']
eilrst = ['lister', 'liters', 'relist', 'tilers']
eilrtt = ['litter', 'littre']
eilrsv = ['livers', 'silver', 'sliver']
adelor = ['loader', 'ordeal', 'reload']
ceklor = ['locker', 'relock']
deloop = ['looped', 'poodle', 'pooled']
deloot = ['looted', 'toledo', 'tooled']
gilnop = ['loping', 'poling']
gilnos = ['losing', 'soling']
eloruv = ['louver', 'louvre', 'velour']
elorsv = ['lovers', 'solver']
elostw = ['lowest', 'owlets', 'towels']
ceiltu = ['lucite', 'luetic', 'uletic']
belmru = ['lumber', 'rumble']
aelnru = ['lunare', 'neural', 'unreal']
elrstu = ['luster', 'lustre', 'result', 'rustle', 'ulster']
gilnsy = ['lyings', 'lysing', 'singly']
aaegmn = ['magnae', 'manage']
aeilmr = ['mailer', 'remail']
aekmrs = ['makers', 'masker']
aceilm = ['maleic', 'malice']
amnors = ['manors', 'ransom', 'romans']
aemnst = ['mantes', 'stamen']
aimmos = ['maoism', 'mimosa']
aelmps = ['maples', 'sample']
aimnor = ['marino', 'minora']
aemrss = ['masers', 'smears']
aehmss = ['mashes', 'shames']
aemrst = ['master', 'stream', 'tamers']
aemstt = ['mattes', 'tamest']
aeemnr = ['meaner', 'rename']
ddeelm = ['meddle', 'melded']
eemnss = ['menses', 'semens']
eemrst = ['merest', 'meters']
aeemrt = ['metrae', 'teamer']
eilmrs = ['milers', 'smiler']
eimntu = ['minuet', 'minute']
eimrss = ['misers', 'remiss']
delmos = ['models', 'seldom']
delmor = ['molder', 'remold']
aemnot = ['moneta', 'omenta']
elmors = ['morels', 'morsel']
emossu = ['mouses', 'mousse', 'osseum']
eimnru = ['murein', 'murine']
gimnsu = ['musing', 'signum']
almtuu = ['mutual', 'umlaut']
chimty = ['mythic', 'thymic']
aelnps = ['naples', 'panels', 'planes']
elnnos = ['nelson', 'nolens']
adenru = ['neurad', 'unread']
ghinst = ['nights', 'things']
ceinot = ['noetic', 'notice']
enorst = ['noster', 'sterno', 'tenors', 'tensor']
elnosv = ['novels', 'sloven', 'volens']
enrrsu = ['nurser', 'reruns']
cioort = ['octroi', 'orotic']
deilos = ['oldies', 'soiled']
eenopr = ['opener', 'reopen', 'repone']
einopr = ['opiner', 'pernio']
gnoppu = ['oppugn', 'popgun']
ciopst = ['optics', 'picots', 'topics']
inoopt = ['option', 'potion']
einort = ['orient', 'tonier']
einost = ['ostein', 'tonies']
eorstt = ['otters', 'tortes', 'toters']
eorstu = ['ouster', 'routes']
enorsw = ['owners', 'resown', 'worsen']
aelpst = ['palest', 'pastel', 'petals', 'plates', 'pleats', 'septal', 'staple']
adnopr = ['pandor', 'pardon']
adenpt = ['panted', 'pedant']
aeppry = ['papery', 'prepay', 'yapper']
aginpr = ['paring', 'raping']
aeprss = ['parses', 'passer', 'repass', 'spares', 'sparse', 'spears']
aeprst = ['partes', 'paster', 'prates', 'repast', 'tapers']
aepsst = ['pastes', 'spates', 'stapes']
aenptt = ['patent', 'patten']
aiopst = ['patios', 'patois']
anoprt = ['patron', 'tarpon']
eelprt = ['pelter', 'petrel']
ehiprs = ['perish', 'reship']
eeprst = ['pester', 'peters', 'preset']
adehps = ['phased', 'shaped']
aehpss = ['phases', 'shapes']
ehnops = ['phones', 'spheno']
ceeipr = ['pierce', 'recipe']
ceinpr = ['pincer', 'prince']
eipprs = ['pipers', 'sipper']
ceipss = ['pisces', 'spices']
ailnpt = ['plaint', 'pliant']
aelnpt = ['planet', 'platen']
elpssu = ['pluses', 'pulses']
eloprs = ['polers', 'sloper']
enopst = ['pontes', 'sponte']
eoprrt = ['porter', 'report']
iopsst = ['posits', 'ptosis']
eoprtu = ['pouter', 'puerto', 'troupe']
aeimpr = ['premia', 'primae']
deiprs = ['prides', 'spider']
eimprs = ['primes', 'simper', 'spirem']
nooprt = ['pronto', 'proton']
einpsu = ['puisne', 'supine']
ilppsu = ['pupils', 'slipup']
eprssu = ['purses', 'supers']
aekqsu = ['quakes', 'squeak']
inqstu = ['quints', 'squint']
iqrstu = ['quirts', 'squirt']
eoqstu = ['quotes', 'toques']
ademor = ['radome', 'roamed']
alortu = ['raoult', 'torula']
aiprst = ['rapist', 'tapirs']
aehrss = ['rashes', 'shares', 'shears']
aanrtt = ['rattan', 'tartan']
aerrtt = ['ratter', 'tarter']
arsttu = ['rattus', 'stuart']
aerstw = ['rawest', 'waster', 'waters']
ddeenr = ['redden', 'rended']
eeersv = ['reeves', 'severe']
efirst = ['refits', 'resift', 'sifter', 'strife']
eeirrt = ['reiter', 'retire']
eeilrs = ['relies', 'resile']
deenrt = ['rented', 'tender']
deeers = ['reseed', 'seeder']
einrss = ['resins', 'rinses', 'sirens']
eeirsz = ['resize', 'seizer']
eorrst = ['resort', 'restor', 'roster', 'sorter']
eerrst = ['rester', 'terser']
eellrt = ['retell', 'teller']
eorrtt = ['retort', 'rotter']
enrrtu = ['return', 'turner']
aeekrw = ['rewake', 'weaker']
deinrw = ['rewind', 'winder']
ehrssu = ['rhesus', 'rhuses', 'rushes', 'ushers']
giinrs = ['rising', 'siring']
giinrv = ['riving', 'virgin']
enortt = ['rotten', 'torten']
deorsu = ['roused', 'soured']
eorssu = ['rouses', 'serous']
anruwy = ['runway', 'unwary']
acehms = ['sachem', 'schema']
aegsst = ['sagest', 'stages']
adelsv = ['salved', 'slaved']
ainsty = ['sanity', 'satiny']
aeirst = ['satire', 'striae']
arssty = ['satyrs', 'strays']
aerssw = ['sawers', 'swears', 'wrasse']
acprss = ['scarps', 'scraps']
eelssv = ['selves', 'vessel']
empstu = ['septum', 'tempus']
eerssv = ['serves', 'severs', 'verses']
eehsst = ['sheets', 'theses']
ehirsv = ['shiver', 'shrive']
aciils = ['sialic', 'silica']
airsst = ['sitars', 'stairs']
adekst = ['skated', 'staked', 'tasked']
aeksst = ['skates', 'stakes', 'steaks']
eelsst = ['sleets', 'steels']
eilmss = ['slimes', 'smiles']
elssty = ['slyest', 'styles']
einpss = ['snipes', 'spines']
elostu = ['solute', 'tousle']
beorst = ['sorbet', 'strobe']
eiorst = ['sortie', 'tories', 'triose']
oprsst = ['sports', 'strops']
aprsst = ['sprats', 'straps']
aenstt = ['stante', 'staten']
aesstt = ['states', 'tastes']
adesty = ['stayed', 'steady']
deestw = ['stewed', 'tweeds']
iprsst = ['stirps', 'strips']
ekorst = ['stoker', 'stroke']
llorst = ['stroll', 'trolls']
ckrstu = ['struck', 'trucks']
abelsu = ['suable', 'usable']
bbdesu = ['subbed', 'subdeb']
ensstu = ['sunset', 'unsets']
arsstu = ['sutras', 'tarsus']
aehstw = ['swathe', 'wheats']
ainstt = ['taints', 'titans']
aerstt = ['taster', 'treats']
emorrt = ['termor', 'tremor']
ehistt = ['theist', 'tithes']
hrsttu = ['thrust', 'truths']
beimrt = ['timber', 'timbre']
hopstu = ['tophus', 'upshot']
ailrst = ['trails', 'trials']
ersttu = ['truest', 'utters']
orttuy = ['tryout', 'tutory']
nprtuu = ['turnup', 'upturn']
aglnuu = ['ungual', 'ungula']
deintu = ['united', 'untied', 'utendi']
dinpuw = ['upwind', 'windup']
aeilnv = ['valine', 'venial']
adestw = ['wadset', 'wasted']
aenrrw = ['warner', 'warren']
ehirtw = ['whiter', 'wither', 'writhe']
deknoz = ['zondek', 'zonked']
aaberst = ['abaters', 'abreast']
aabdelt = ['ablated', 'datable']
abeorrt = ['aborter', 'taborer']
aabcert = ['abreact', 'cabaret']
abceiss = ['abscise', 'scabies']
aberttu = ['abutter', 'batture']
aaccdes = ['accedas', 'cascade', 'saccade']
accersu = ['accrues', 'accurse', 'accuser']
aceinot = ['acetoin', 'aconite', 'anoetic']
acinnot = ['actinon', 'contain']
acersst = ['actress', 'casters', 'recasts']
aaadmnt = ['adamant', 'mandata']
aadeprt = ['adapter', 'readapt']
adeehrr = ['adherer', 'reheard']
aadiips = ['adipsia', 'aspidia']
adeimrs = ['admires', 'misread', 'sidearm']
adeorrs = ['adorers', 'roaders']
adeorsv = ['adverso', 'savored']
aeloors = ['aerosol', 'roseola']
aegirst = ['agister', 'gaiters', 'stagier']
aeilnor = ['aileron', 'alienor']
aeilmss = ['aimless', 'melissa']
aeilrss = ['airless', 'laisser', 'serials']
aabelrt = ['alberta', 'ratable']
acelosv = ['alcoves', 'coevals']
aeelrrt = ['alerter', 'alterer', 'relater']
aaegilr = ['algeria', 'railage', 'regalia']
aeeglls = ['alleges', 'legales']
aegllno = ['allonge', 'galleon']
adlmnos = ['almonds', 'dolmans']
aadimor = ['amaroid', 'diorama']
abgilmn = ['ambling', 'blaming', 'lambing']
adeemns = ['amendes', 'demeans']
aaeimnt = ['amentia', 'aminate', 'animate']
aceimns = ['amnesic', 'cinemas']
ahimopr = ['amorphi', 'morphia', 'phormia']
aademns = ['anadems', 'maenads']
achnors = ['anchors', 'archons']
aceginr = ['anergic', 'grecian']
aaaginr = ['angaria', 'niagara']
acegiln = ['angelic', 'galenic']
aagilnn = ['anginal', 'anglian']
aailmns = ['animals', 'laminas', 'malians']
aaeinst = ['anisate', 'taenias']
aaennst = ['annates', 'tannase']
adennoy = ['annoyed', 'anodyne']
ainnost = ['anoints', 'nations', 'onanist']
aenrssw = ['answers', 'rawness']
aelnrst = ['antlers', 'rentals', 'sternal']
aelnpty = ['aplenty', 'penalty']
aeipprs = ['apprise', 'sappier']
aacchir = ['arachic', 'archaic']
aacders = ['arcades', 'caderas']
acehrst = ['archest', 'chaster']
acgiknr = ['arcking', 'racking']
aemrrst = ['armrest', 'smarter']
aerrsst = ['arrests', 'rasters', 'starers']
aeimrst = ['artemis', 'maestri', 'maitres', 'smartie']
aeirstt = ['artiest', 'artiste', 'attires', 'striate', 'tastier']
airsstt = ['artists', 'straits']
aacdirs = ['ascarid', 'cardias']
aceisst = ['ascites', 'ectasis']
aeeprss = ['asperse', 'pareses', 'serapes']
aeiprss = ['aspires', 'paresis', 'praises', 'spireas']
aaegssu = ['assuage', 'sausage']
adeirst = ['astride', 'staider', 'tirades']
aenorst = ['atoners', 'senator', 'treason']
aeiopst = ['atopies', 'opiates']
aceirst = ['atresic', 'cristae', 'raciest', 'stearic']
adenttu = ['attuned', 'taunted']
acinotu = ['auction', 'caution']
aegmntu = ['augment', 'mutagen']
aceostv = ['avocets', 'octaves']
abbbelr = ['babbler', 'blabber']
abilotu = ['bailout', 'obitual']
abeelns = ['baleens', 'enables']
abeglns = ['bangles', 'bengals']
abimpst = ['baptism', 'bitmaps']
abgginr = ['barging', 'garbing']
abemort = ['barmote', 'bromate']
abehrst = ['bathers', 'breaths']
abelstt = ['battles', 'tablets']
abeemrs = ['beamers', 'besmear']
abeehrt = ['beareth', 'breathe']
bdemoor = ['bedroom', 'boredom', 'broomed']
bceeehs = ['beeches', 'beseech']
abdeelt = ['belated', 'bleated']
bdeeill = ['bellied', 'libeled']
abdenrr = ['bernard', 'brander']
abdeest = ['bestead', 'debates']
beerstw = ['bestrew', 'webster']
beillrs = ['billers', 'rebills']
abdeilp = ['bipedal', 'piebald']
abeirrz = ['bizarre', 'brazier']
bdeilnr = ['blinder', 'brindle']
abdelot = ['bloated', 'lobated']
bddeloo = ['blooded', 'boodled']
belortt = ['blotter', 'bottler']
belossu = ['blouses', 'boluses']
bgilnow = ['blowing', 'bowling']
bdelnru = ['blunder', 'bundler']
belrstu = ['bluster', 'bustler', 'butlers', 'subtler']
abdeorr = ['boarder', 'broader']
beilors = ['boilers', 'liberos', 'reboils']
bbgimno = ['bombing', 'mobbing']
bginoss = ['bossing', 'gibsons']
boopstx = ['boxtops', 'postbox']
abdeirs = ['braised', 'seabird']
abdelrw = ['brawled', 'warbled']
bbeirrs = ['bribers', 'ribbers']
bdeefir = ['briefed', 'debrief']
bdekoor = ['brooked', 'redbook']
beffrsu = ['buffers', 'rebuffs']
bggilnu = ['bugling', 'bulging']
bellosu = ['bullose', 'lobules', 'soluble']
belsstu = ['bustles', 'sublets']
accghin = ['caching', 'chacing']
acceklr = ['cackler', 'clacker', 'crackle']
acinoss = ['caisson', 'casinos']
acdelns = ['calends', 'candles']
aceilpr = ['caliper', 'replica']
acellos = ['callose', 'locales']
accelsy = ['calyces', 'cyclase']
acemprs = ['campers', 'scamper']
acdeins = ['candies', 'incased']
acenrst = ['canters', 'nectars', 'recants', 'trances']
acnorst = ['cantors', 'cartons', 'cratons']
aaclnsu = ['canulas', 'lacunas']
aacnpst = ['capstan', 'catnaps']
acelpsu = ['capsule', 'specula', 'upscale']
aaaccrs = ['caracas', 'cascara']
aceerrs = ['careers', 'creaser']
aceimnr = ['carmine', 'crimean']
acdemor = ['caromed', 'comrade']
acelprs = ['carpels', 'clasper', 'parcels', 'placers', 'scalper']
aceprst = ['carpets', 'spectra']
acelrst = ['cartels', 'clarets', 'scarlet']
acginrt = ['carting', 'crating', 'tracing']
acginrv = ['carving', 'craving']
acghins = ['cashing', 'chasing']
aceilst = ['castile', 'elastic', 'laciest']
aceerrt = ['caterer', 'recrate', 'retrace', 'terrace']
acerssu = ['causers', 'cerasus', 'saucers', 'sucrase']
aacestv = ['caveats', 'vacates']
cdeenst = ['cedents', 'descent', 'scented']
ceenrss = ['censers', 'screens']
acceimr = ['ceramic', 'racemic']
aceelrs = ['cereals', 'sclerae']
cceiort = ['cerotic', 'orectic']
ceinoss = ['cession', 'cosines']
ceisstu = ['cestuis', 'cutises', 'ictuses']
acdehkl = ['chalked', 'hackled']
achnnos = ['chanson', 'noncash']
acehprt = ['chapter', 'patcher']
acdehmr = ['charmed', 'marched']
aacehrt = ['chartae', 'trachea']
acehrtt = ['chatter', 'ratchet']
acehrty = ['cheatry', 'yachter']
ceehrst = ['chester', 'etchers', 'retches']
ccehior = ['choicer', 'choreic']
cghikno = ['choking', 'hocking']
achlors = ['chorals', 'scholar']
cdehosu = ['choused', 'douches']
cdeinrs = ['cinders', 'discern', 'rescind']
cceilrs = ['circles', 'clerics']
acdeilt = ['citadel', 'delicta', 'deltaic', 'dialect', 'edictal']
acdeilm = ['claimed', 'decimal', 'declaim', 'medical']
acdegln = ['clanged', 'glanced']
acdelps = ['clasped', 'scalped']
aceelns = ['cleanse', 'scalene']
ceilnst = ['clients', 'stencil']
ceilppr = ['clipper', 'cripple']
celosst = ['closest', 'closets']
celrstu = ['cluster', 'cutlers']
acenors = ['coarsen', 'corneas', 'narcose']
acceino = ['cocaine', 'oceanic']
cddelos = ['coddles', 'scolded']
cehiors = ['coheirs', 'heroics']
ceinors = ['coiners', 'cronies', 'recoins']
celnoos = ['colones', 'console']
bcemors = ['combers', 'recombs']
cdnoors = ['condors', 'cordons']
cinosst = ['consist', 'tocsins']
cekoors = ['cookers', 'recooks']
celoost = ['coolest', 'ocelots']
coopstu = ['copouts', 'octopus']
aclopsu = ['copulas', 'cupolas']
cdeorrs = ['corders', 'records']
ceikorr = ['corkier', 'rockier']
cenorrs = ['corners', 'scorner']
cenoorr = ['coroner', 'crooner']
ceorsst = ['corsets', 'escorts', 'sectors']
celnosu = ['counsel', 'unclose']
cnoopsu = ['coupons', 'soupcon']
ceorrsu = ['courser', 'recours']
ceeorrv = ['coverer', 'recover']
acimnru = ['cranium', 'cumarin']
aceorrt = ['creator', 'reactor']
cdeeerr = ['credere', 'decreer']
aceenrt = ['crenate', 'reenact']
ceiprrs = ['crisper', 'pricers']
cderstu = ['crudest', 'crusted']
ceirrsu = ['cruiser', 'curries']
cflpsuu = ['cupfuls', 'cupsful']
acinrtu = ['curtain', 'turacin']
cerstuy = ['curtesy', 'curtsey']
celsttu = ['cutlets', 'scuttle']
ademnos = ['daemons', 'monades']
adeiirs = ['dairies', 'diaries']
adeillr = ['dallier', 'rallied']
adempst = ['dampest', 'stamped']
adegnrs = ['dangers', 'ganders', 'gardens']
adeglns = ['dangles', 'glandes']
adgilnr = ['darling', 'larding']
adenrrs = ['darners', 'errands']
aderrst = ['darters', 'retards', 'starred', 'traders']
adghins = ['dashing', 'shading']
addentu = ['daunted', 'undated']
addelrw = ['dawdler', 'drawled', 'waddler']
addeest = ['deadest', 'sedated']
adeelrs = ['dealers', 'leaders']
adehrst = ['dearths', 'hardest', 'hatreds', 'threads', 'trashed']
acdenst = ['decants', 'descant', 'scanted']
cddeeor = ['decoder', 'recoded']
cdeeers = ['decrees', 'recedes', 'seceder']
cdeeirs = ['decries', 'deicers']
cddeeru = ['deducer', 'reduced']
ddeegin = ['deeding', 'deigned']
adefltu = ['default', 'faulted']
ddeefil = ['defiled', 'fielded']
deefils = ['defiles', 'fideles']
defmors = ['deforms', 'serfdom']
ddeefii = ['deified', 'edified']
cdeiist = ['deistic', 'diciest']
adelort = ['delator', 'leotard']
deeelst = ['deletes', 'sleeted', 'steeled']
deiilmt = ['delimit', 'limited']
addemns = ['demands', 'maddens']
deeemrt = ['demeter', 'metered']
demnotu = ['demount', 'mounted']
deginnt = ['denting', 'tending']
deenrtu = ['denture', 'tenured']
adeelnp = ['deplane', 'paneled']
deoprst = ['deports', 'sported']
deeoprs = ['deposer', 'reposed']
adeeprv = ['deprave', 'pervade', 'repaved']
adeginr = ['deraign', 'grained', 'reading']
deeimrs = ['dereism', 'remised']
deeirsv = ['derives', 'deviser', 'diverse', 'revised']
deeersv = ['deserve', 'severed']
deeirss = ['desires', 'resides']
adeinst = ['destain', 'detains', 'instead', 'sainted', 'stained']
deeintt = ['detinet', 'dinette']
deiortt = ['detroit', 'dottier']
deelovv = ['devolve', 'evolved']
adimost = ['diatoms', 'distoma', 'mastoid']
degiint = ['dieting', 'editing', 'ignited']
deilstu = ['dilutes', 'duelist']
deioprt = ['diopter', 'proteid', 'protide']
dghiins = ['dishing', 'shindig']
dioprst = ['disport', 'tripods']
deiistt = ['ditties', 'tidiest']
deegirv = ['diverge', 'grieved']
deeinpr = ['dnieper', 'repined', 'ripened']
degglos = ['doglegs', 'slogged']
adimnos = ['domains', 'madison']
ddeloor = ['doodler', 'drooled']
bdeortu = ['doubter', 'obtrude', 'redoubt']
adegorw = ['dowager', 'wordage']
deiorsw = ['dowries', 'rowdies', 'weirdos']
adefrrt = ['drafter', 'redraft']
adeprrs = ['drapers', 'sparred']
adginrw = ['drawing', 'warding']
adeemrr = ['dreamer', 'rearmed']
deillrr = ['driller', 'redrill']
ddeggru = ['drugged', 'grudged']
degilnu = ['dueling', 'eluding', 'indulge']
deimpru = ['dumpier', 'umpired']
adenrtu = ['durante', 'natured', 'unrated']
deirstu = ['dustier', 'reditus', 'studier']
aeeglst = ['eaglets', 'legates']
aeenrst = ['earnest', 'eastern', 'nearest']
aeglpru = ['earplug', 'graupel', 'plaguer']
aehlrty = ['earthly', 'lathery']
aceilrs = ['eclairs', 'scalier']
eghhist = ['eighths', 'heights', 'highest']
adeelps = ['elapsed', 'pleased']
aeilnst = ['elastin', 'entails', 'salient', 'saltine']
aeilnot = ['elation', 'toenail']
eiilmst = ['elitism', 'limiest', 'melitis']
aaeemnt = ['emanate', 'enemata', 'manatee']
eegimrs = ['emigres', 'regimes']
eeimrtt = ['emitter', 'termite']
egimnot = ['emoting', 'mitogen']
aeimopr = ['emporia', 'meropia']
acenort = ['enactor', 'necator']
aceenss = ['encases', 'seances', 'senecas']
ceenors = ['encores', 'necrose']
deenorw = ['endower', 'reendow']
denorsu = ['enduros', 'resound', 'sounder']
deflnos = ['enfolds', 'fondles']
eghilns = ['english', 'shingle']
aegimns = ['enigmas', 'gamines', 'seaming']
aeeglnr = ['enlarge', 'general', 'gleaner']
eglnooy = ['enology', 'neology']
deeilns = ['ensiled', 'linseed']
aeelnrt = ['enteral', 'eternal']
ceeinrt = ['enteric', 'enticer']
aenprst = ['entraps', 'parents', 'pastern']
deeimpr = ['epiderm', 'impeder']
eeeimpr = ['epimere', 'preemie']
deilopu = ['epuloid', 'euploid']
deginor = ['eroding', 'ignored', 'negroid', 'redoing']
aemrrtu = ['erratum', 'maturer']
aceehst = ['escheat', 'teaches']
acehmrs = ['esmarch', 'marches']
aeerstt = ['estreat', 'restate']
eilorst = ['estriol', 'loiters', 'sertoli', 'toilers']
aelrstu = ['estrual', 'saluter']
eekorsv = ['evokers', 'revokes']
ceepstx = ['excepts', 'expects']
eeiprsx = ['expires', 'prexies']
aacfils = ['facials', 'fascial']
acflnos = ['falcons', 'flacons']
aefinns = ['fannies', 'fenians']
afgimnr = ['farming', 'framing']
aefsstt = ['fastest', 'setfast']
eefgiln = ['feeling', 'fleeing']
aeefllt = ['fellate', 'leaflet']
deefirr = ['ferried', 'refired', 'refried']
eeflrsu = ['ferules', 'refuels']
efillrs = ['fillers', 'refills']
aefgiln = ['finagle', 'leafing']
efginrs = ['fingers', 'fringes']
efirssu = ['fissure', 'fussier']
aacflrt = ['flatcar', 'fractal']
defilrt = ['flirted', 'trifled']
fgilnow = ['flowing', 'fowling']
afgilno = ['foaling', 'loafing']
aefmnor = ['foramen', 'foreman']
efmorrs = ['formers', 'reforms']
acfinrt = ['frantic', 'infarct', 'infract']
eefhrrs = ['fresher', 'refresh']
defnrsu = ['funders', 'refunds']
efirstu = ['fustier', 'surfeit']
aaegllt = ['gallate', 'tallage']
aggginn = ['ganging', 'nagging']
aegnrst = ['garnets', 'strange']
aegrrst = ['garrets', 'garters', 'graters']
aginrst = ['gastrin', 'ratings', 'staring']
adeeglt = ['gelated', 'legated']
eginort = ['genitor', 'integro', 'trigone']
degnrsu = ['gerunds', 'nudgers']
bbginos = ['gibbons', 'sobbing']
dggiiln = ['gilding', 'gliding']
egginry = ['gingery', 'greying']
ddegilr = ['girdled', 'griddle']
aeglrss = ['glasser', 'largess']
egilnst = ['glisten', 'tingles']
degilor = ['gloried', 'godlier']
eglorsv = ['glovers', 'grovels']
egiorst = ['goiters', 'goriest']
adegrrs = ['graders', 'regards']
aadgmnr = ['grandam', 'grandma']
aeginrt = ['granite', 'ingrate', 'integra', 'tangier', 'tearing']
aegrruv = ['gravure', 'verruga']
aeegrrt = ['greater', 'regrate']
egilmnr = ['gremlin', 'mingler']
deginnr = ['grinned', 'rending']
egorrsw = ['growers', 'regrows']
degnoru = ['guerdon', 'undergo']
ghnostu = ['gunshot', 'shotgun']
egirstu = ['gustier', 'gutsier']
acehkrs = ['hackers', 'shacker']
aachksw = ['hacksaw', 'kwachas']
aehlrst = ['halters', 'lathers', 'slather']
aehmmrs = ['hammers', 'shammer']
adffhno = ['handoff', 'offhand']
aehknrs = ['hankers', 'harkens']
adehirr = ['hardier', 'harried']
aehiprs = ['harpies', 'sharpie']
aehlsss = ['hassles', 'slashes']
aehnrtu = ['haunter', 'unearth', 'urethan']
adehinp = ['headpin', 'pinhead']
aeehrst = ['heaters', 'reheats']
deeghin = ['heeding', 'neighed']
eehinrs = ['henries', 'inheres']
deeehrs = ['heredes', 'sheered']
ehirstt = ['hitters', 'tithers']
dhlopsu = ['holdups', 'upholds']
ehilost = ['holiest', 'hostile']
ehoorst = ['hooters', 'shooter', 'soother']
dehmoru = ['hordeum', 'humored']
ghinors = ['horsing', 'shoring']
ddehlru = ['huddler', 'hurdled']
ehnrstu = ['hunters', 'shunter']
ehlrstu = ['hurtles', 'hustler']
adehrty = ['hydrate', 'thready']
cdeiint = ['identic', 'incited']
beimrsu = ['imbrues', 'imburse']
aeilmpr = ['impaler', 'impearl', 'lempira', 'palmier']
eimpstu = ['impetus', 'imputes']
eimoprs = ['imposer', 'promise', 'semipro']
eimprst = ['imprest', 'permits']
aciilns = ['incisal', 'salicin']
cdeilnu = ['include', 'nuclide']
deinnst = ['indents', 'intends']
eginsst = ['ingests', 'signets']
agiinnr = ['ingrain', 'raining']
giiknns = ['inkings', 'sinking']
giinnns = ['innings', 'sinning']
egiinns = ['insigne', 'seining']
eiinprs = ['inspire', 'spinier']
aeilnsu = ['insulae', 'inulase']
einrssu = ['insures', 'sunrise']
eiimnrt = ['interim', 'mintier', 'termini']
deinrtu = ['intrude', 'untired', 'untried']
giinnru = ['inuring', 'ruining']
einrstv = ['inverts', 'striven']
aeilrty = ['irately', 'reality']
eiinors = ['ironies', 'noisier']
eimorss = ['isomers', 'mossier']
eiorsst = ['isoster', 'rosiest', 'sorties', 'stories']
agiknoy = ['kayoing', 'okaying']
eegiknp = ['keeping', 'peeking']
aeiknrs = ['kerasin', 'snakier']
giiknnp = ['kingpin', 'pinking']
eikpprs = ['kippers', 'skipper']
eiknrtt = ['knitter', 'trinket']
acgilns = ['lacings', 'scaling']
addelrs = ['ladders', 'saddler']
aailmms = ['lamaism', 'miasmal']
aaeilmn = ['laminae', 'melania']
adgilnu = ['languid', 'lauding']
agilnps = ['lapsing', 'palings', 'sapling']
aehlrss = ['lashers', 'slasher']
agilnst = ['lasting', 'salting', 'slating', 'staling']
aceiltt = ['lattice', 'tactile']
alostuy = ['layouts', 'outlays']
aeeglru = ['leaguer', 'regulae']
aeelprs = ['leapers', 'pleaser', 'relapse', 'repeals']
aeelnrr = ['learner', 'relearn']
aeelrsv = ['leavers', 'reveals', 'several']
egilnos = ['legions', 'lingoes']
eillnst = ['lentils', 'lintels']
eloprsu = ['leprous', 'sporule']
acelnvy = ['levancy', 'valency']
eeilrsv = ['leviers', 'relives', 'reviles', 'servile']
ceiklrs = ['lickers', 'slicker']
aeilmnn = ['lineman', 'melanin']
agillnu = ['lingual', 'lingula']
ailmops = ['lipomas', 'spiloma']
giilnps = ['lisping', 'pilings']
giilnst = ['listing', 'silting']
ehilstt = ['lithest', 'thistle']
aelnors = ['loaners', 'orleans', 'reloans']
bbelors = ['lobbers', 'slobber']
efilort = ['loftier', 'trefoil']
gilnoop = ['looping', 'pooling']
eloorst = ['looters', 'toolers']
elopprs = ['loppers', 'propels']
delostu = ['loudest', 'tousled']
belmrsu = ['lumbers', 'rumbles', 'slumber']
gilmnpu = ['lumping', 'pluming']
aaegmnt = ['magenta', 'magnate']
adeimns = ['maidens', 'medians', 'sideman']
agikmns = ['makings', 'masking']
aegimnr = ['mangier', 'reaming']
aamnprt = ['mantrap', 'rampant']
aemnrsu = ['manures', 'surname']
aaacmrs = ['maracas', 'mascara']
agimnrs = ['margins', 'migrans']
aailmrt = ['marital', 'martial']
aehmrss = ['marshes', 'mashers', 'smasher']
aghimns = ['mashing', 'shaming']
aemrsty = ['mastery', 'streamy']
amnorst = ['matrons', 'transom']
aelmrsu = ['maulers', 'serumal']
adeemnr = ['meander', 'reamend', 'renamed']
degilmn = ['melding', 'mingled']
aeilmns = ['menials', 'salmine', 'seminal']
eimnors = ['merinos', 'moriens']
deimmrt = ['midterm', 'trimmed']
aeimnrt = ['minaret', 'raiment']
eimnrst = ['minster', 'minters']
eimnstu = ['minuets', 'minutes', 'mistune']
eiimrst = ['miriest', 'mistier']
eilmrsu = ['misrule', 'muliers']
eimrsst = ['misters', 'smiters']
eimrssu = ['misuser', 'surmise']
deelmor = ['modeler', 'remodel']
acdimno = ['monadic', 'nomadic']
aeimnor = ['moraine', 'romaine']
almorst = ['mortals', 'stromal']
emnortu = ['mounter', 'remount']
egglmsu = ['muggles', 'smuggle']
aimnrru = ['murrain', 'murrina']
agmnstu = ['mustang', 'stagnum']
aeinstv = ['naivest', 'natives']
aeinpps = ['nappies', 'pinesap']
aeinrtt = ['nattier', 'nitrate', 'tertian']
aelnrtu = ['naturel', 'neutral']
deeenrs = ['needers', 'sneered']
cehinpr = ['nephric', 'phrenic', 'pincher']
eenrsst = ['nesters', 'resents']
eelnrst = ['nestler', 'relents']
eeinrtu = ['neurite', 'retinue', 'reunite', 'uterine']
eenrstu = ['neuters', 'tenures', 'tureens']
ceiknrs = ['nickers', 'snicker']
einpprs = ['nippers', 'snipper']
ceinost = ['notices', 'section']
acelnru = ['nuclear', 'unclear']
beeorsv = ['observe', 'obverse', 'verbose']
deffnos = ['offends', 'sendoff']
deimott = ['omitted', 'totidem']
eenoprs = ['openers', 'reopens']
inoopst = ['options', 'potions']
aginort = ['orating', 'trigona']
agnnoor = ['organon', 'rangoon']
adlnoor = ['orlando', 'rolando']
opsttuu = ['outputs', 'putouts']
deiostu = ['outside', 'tedious']
koortuw = ['outwork', 'workout']
aeeortv = ['overate', 'overeat']
acekprs = ['packers', 'repacks']
aeinprt = ['painter', 'pertain', 'repaint']
aelprst = ['palters', 'plaster', 'psalter', 'stapler']
aeinpss = ['pansies', 'sapiens']
aeepprr = ['paperer', 'prepare']
aginprs = ['parings', 'parsing', 'rasping', 'sparing']
aeloprr = ['paroler', 'peroral', 'preoral']
aeiprrs = ['parries', 'praiser', 'rapiers', 'raspier', 'repairs']
aeprrst = ['parters', 'praters']
aeiprst = ['parties', 'pastier', 'piaster', 'pirates', 'traipse']
aelpsst = ['pastels', 'staples']
aeprstu = ['pasteur', 'pasture']
aloprst = ['patrols', 'portals']
aeprstt = ['patters', 'spatter']
cdeeilp = ['pedicel', 'pedicle']
eelprst = ['pelters', 'petrels']
aeennpt = ['pennate', 'pentane']
eeipppr = ['peppier', 'preppie']
ceepprt = ['percept', 'precept']
ceefprt = ['perfect', 'prefect']
deeilpr = ['periled', 'replied']
eeinopr = ['peronei', 'pioneer']
eeoprss = ['peroses', 'reposes']
aenoprs = ['persona', 'pronase']
aelprsu = ['perusal', 'pleuras']
adeelpt = ['petaled', 'pleated']
aehnopt = ['phaeton', 'phonate']
aghinps = ['phasing', 'shaping']
adehprs = ['phrased', 'sharped']
ceikpst = ['pickets', 'skeptic']
giiknps = ['pigskin', 'spiking']
einnprs = ['pinners', 'spinner']
eiiprst = ['pitiers', 'tipsier']
ailnpst = ['plaints', 'plastin']
aelnpst = ['planets', 'platens']
adelopt = ['platode', 'tadpole']
adeelpr = ['pleader', 'replead']
einoprt = ['pointer', 'protein', 'pterion', 'tropine']
deloops = ['poodles', 'spooled']
eoprrst = ['porters', 'reports']
eoprsst = ['posters', 'reposts']
eoprstu = ['posture', 'pouters', 'proteus', 'troupes']
aeoprrt = ['praetor', 'prorate']
adeeprt = ['predate', 'tapered']
eenprst = ['present', 'repents', 'serpent']
eemprsu = ['presume', 'supreme']
einprrt = ['printer', 'reprint']
emooprt = ['promote', 'temporo']
aelpstu = ['pulsate', 'septula', 'spatule']
enprstu = ['punster', 'punters']
eprrsuu = ['pursuer', 'usurper']
eeqrstu = ['quester', 'request']
eoqrstu = ['quoters', 'torques']
acdeirs = ['radices', 'sidecar']
adeegrw = ['ragweed', 'wagered']
ademnrs = ['ramsden', 'remands']
aehrrss = ['rashers', 'sharers']
aelrstt = ['rattles', 'starlet', 'startle']
aiilorv = ['ravioli', 'varolii']
aeelrst = ['realest', 'relates', 'stealer']
aeemrrs = ['reamers', 'smearer']
ceerrsu = ['recurse', 'rescuer', 'securer']
acdeprs = ['redcaps', 'scraped']
deenrss = ['redness', 'senders']
eeginrv = ['reeving', 'veering']
aeflrtu = ['refutal', 'tearful']
eelmrst = ['remelts', 'smelter']
aelmorv = ['removal', 'valorem']
aeeprst = ['repeats', 'sperate']
ellorrs = ['rerolls', 'rollers']
aeersst = ['reseats', 'teasers']
eellrss = ['resells', 'sellers']
eirssst = ['resists', 'sisters']
ceeprst = ['respect', 'scepter', 'specter']
aeffrst = ['restaff', 'staffer']
eginrst = ['resting', 'stinger']
eelrsty = ['restyle', 'tersely']
eellrst = ['retells', 'tellers']
ehiknrt = ['rethink', 'thinker']
deeirrt = ['retired', 'retried']
eorrstt = ['retorts', 'stertor']
aeerrtt = ['retreat', 'treater']
eeirrrt = ['retrier', 'terrier']
eeirsvw = ['reviews', 'viewers']
aemrrsw = ['rewarms', 'warmers']
deelrsw = ['rewelds', 'welders']
deeirrw = ['rewired', 'weirder']
aeprrsw = ['rewraps', 'warpers']
ceikrst = ['rickets', 'sticker', 'tickers']
egilnrt = ['ringlet', 'tingler']
eilpprs = ['ripples', 'slipper']
eoorrst = ['rooster', 'rooters']
aeorstt = ['rotates', 'toaster']
eorrstu = ['rouster', 'routers', 'trouser']
deiorrw = ['rowdier', 'wordier', 'worried']
abellru = ['rubella', 'rulable']
erssstu = ['russets', 'trusses']
acehmss = ['sachems', 'schemas']
agilnsv = ['salving', 'slaving']
aceilns = ['sanicle', 'scaleni']
aeensst = ['sateens', 'senates', 'sensate']
aceprss = ['scrapes', 'spacers']
deeehst = ['seethed', 'sheeted']
aeerrst = ['serrate', 'tearers']
aenrstv = ['servant', 'taverns']
eginstt = ['setting', 'testing']
ehorstu = ['shouter', 'souther']
cdeikls = ['sickled', 'slicked']
egiinsv = ['sieving', 'viseing']
aginors = ['signora', 'soaring']
aekrsst = ['skaters', 'streaks']
eikrrst = ['skirter', 'striker']
deilstt = ['slitted', 'stilted']
enorrst = ['snorter', 'torrens']
ennosst = ['sonnets', 'stenson']
aeilnps = ['spaniel', 'splenia']
eiprstt = ['spitter', 'tipster']
aeggrst = ['stagger', 'taggers']
aprsttu = ['startup', 'upstart']
aestttu = ['statute', 'tautest']
deenrst = ['stender', 'tenders']
eginstw = ['stewing', 'twinges']
eiknrst = ['stinker', 'tinkers']
eilppst = ['stipple', 'tipples']
ekorsst = ['stokers', 'strokes']
eloppst = ['stopple', 'topples']
ciorstt = ['stricto', 'tricots']
belmstu = ['stumble', 'tumbles']
denrssu = ['sunders', 'undress']
nopsstu = ['sunspot', 'unstops']
gginrsu = ['surging', 'urgings']
aeerrsw = ['swearer', 'wearers']
eeeprsw = ['sweeper', 'weepers']
eginrsw = ['swinger', 'wingers']
allotwy = ['tallowy', 'tollway']
adeirrt = ['tardier', 'tarried']
aelrttt = ['tartlet', 'tattler']
aeinrtw = ['tawnier', 'tinware']
aeehrtt = ['theater', 'thereat']
giilntt = ['tilting', 'titling']
eirsttt = ['titters', 'tritest']
iorsttu = ['tourist', 'tutoris']
imrsstu = ['trismus', 'truisms']
belmrtu = ['tumbler', 'tumbrel']
aelnruv = ['unravel', 'venular']
adenrtv = ['ventrad', 'verdant']
aeirstw = ['waiters', 'wariest', 'wastier']
aeglnrw = ['wangler', 'wrangle']
deeehlw = ['wheedle', 'wheeled']
eggilrw = ['wiggler', 'wriggle']
abdehorr = ['abhorred', 'harbored']
abdegirs = ['abridges', 'brigades']
aaacdinr = ['acaridan', 'arcadian']
acceortu = ['accouter', 'accoutre']
aceinost = ['aconites', 'actiones', 'canoeist', 'sonicate']
acciorst = ['acrostic', 'socratic']
aaceittv = ['activate', 'cavitate']
aadeprst = ['adapters', 'readapts']
adejrstu = ['adjuster', 'readjust']
adilorty = ['adroitly', 'dilatory', 'idolatry']
aacdensv = ['advances', 'canvased']
aceilnsu = ['aesculin', 'lunacies']
aeeginss = ['agenesis', 'assignee']
aaegimnt = ['agmatine', 'agminate', 'enigmata']
aeilmnst = ['ailments', 'aliments', 'manliest', 'mentalis']
aagilmnr = ['alarming', 'marginal']
accehilm = ['alchemic', 'chemical']
aegilnrt = ['alerting', 'altering', 'integral', 'relating', 'triangle']
aaceilln = ['alliance', 'canaille']
aellortt = ['allotter', 'totaller']
adeilttu = ['altitude', 'latitude']
ailrsttu = ['altruist', 'ultraist']
aaemortt = ['amaretto', 'teratoma']
aabeelmn = ['amenable', 'nameable']
aaceimrs = ['americas', 'mesaraic']
aiimosst = ['amitosis', 'omasitis']
aeimortz = ['amortize', 'atomizer']
acenorst = ['ancestor', 'enactors', 'entosarc']
aceinrst = ['anestric', 'canister', 'cisterna', 'scantier']
aenrsstu = ['anestrus', 'saunters']
aaeginrs = ['angaries', 'arginase']
aacgilnn = ['anglican', 'canaling']
aaeimnrt = ['animater', 'marinate']
aeinorst = ['anoestri', 'asterion', 'notaries', 'rationes']
adeinott = ['antidote', 'tetanoid']
aimnnoty = ['antimony', 'antinomy']
aceinopr = ['apocrine', 'procaine']
aaeepprr = ['appearer', 'reappear']
aceginrt = ['argentic', 'catering', 'creating', 'reacting']
aegiinnr = ['arginine', 'nigerian']
aacimort = ['aromatic', 'macrotia']
aeerrrst = ['arrester', 'rearrest']
aeeinrst = ['arsenite', 'resinate', 'trainees']
aeeirrst = ['arteries', 'rareties']
aeinrsst = ['artiness', 'stainers']
acdeenrs = ['ascender', 'reascend']
aaeimprs = ['aspermia', 'sapremia']
aeeprsss = ['asperses', 'repasses']
aainprst = ['aspirant', 'partisan']
agiinprs = ['aspiring', 'pairings', 'praising']
adeensst = ['assented', 'standees']
aenorsst = ['assentor', 'senators', 'treasons']
aeorrsst = ['assertor', 'assorter', 'reassort', 'roasters']
aginorss = ['assignor', 'signoras']
aaeinstt = ['astatine', 'sanitate']
aeeilrst = ['ateliers', 'earliest', 'realties']
aimosstt = ['atomists', 'somatist']
aacehrtt = ['attacher', 'reattach']
addeentt = ['attended', 'dentated']
aeorsttt = ['attestor', 'testator']
acinostu = ['auctions', 'cautions']
aeegnrsv = ['avengers', 'engraves']
abbbelrs = ['babblers', 'blabbers']
abcekrst = ['backrest', 'brackets']
abceinrt = ['bacterin', 'centibar']
abeeilns = ['balinese', 'baseline']
aabcilms = ['balsamic', 'cabalism']
abdeeist = ['beadiest', 'diabetes']
abemnotu = ['beaumont', 'umbonate']
abegilns = ['belgians', 'signable', 'singable']
beinnoss = ['benisons', 'boniness']
abcdeehr = ['berdache', 'breached']
abeirsty = ['bestiary', 'sybarite']
aabelrty = ['betrayal', 'rateably']
abeiilnr = ['bilinear', 'liberian']
abcdiilo = ['biocidal', 'diabolic']
aabelmst = ['blastema', 'lambaste']
abegilnt = ['bleating', 'tangible']
beilrsst = ['blisters', 'bristles']
abgilnot = ['bloating', 'obligant']
bdgilnoo = ['blooding', 'boodling']
bgilnott = ['blotting', 'bottling']
bbbelrsu = ['blubbers', 'bubblers']
bdelnrsu = ['blunders', 'bundlers']
abegmnoy = ['bogeyman', 'moneybag']
belorsst = ['bolsters', 'lobsters']
abcekoos = ['bookcase', 'casebook']
bdelorsu = ['boulders', 'doublers']
abelrrsw = ['brawlers', 'warblers']
abekortu = ['breakout', 'outbreak']
abdillry = ['bridally', 'ribaldly']
bdeilrst = ['bristled', 'driblets']
abckssuw = ['bucksaws', 'sawbucks']
bdeilrsu = ['builders', 'rebuilds']
bcehrstu = ['butchers', 'schubert']
beerrttu = ['butterer', 'rebutter']
acceklrs = ['cacklers', 'clackers', 'crackles']
accdesuu = ['caduceus', 'caucused']
acceirsu = ['caesuric', 'curacies']
aceilprs = ['calipers', 'replicas', 'spiracle']
acelmstu = ['calumets', 'muscatel']
aceimpst = ['campiest', 'campsite']
acceelnr = ['canceler', 'clarence']
acinnost = ['canonist', 'contains', 'sanction']
aacelpsu = ['capsulae', 'scapulae']
acinopst = ['captions', 'pontiacs']
acillnor = ['carillon', 'corallin']
acdellor = ['carolled', 'collared']
acehirss = ['cashiers', 'rachises']
aacllsuy = ['casually', 'causally']
aaceilrv = ['cavalier', 'variceal']
ceeemnrt = ['cementer', 'cerement']
acenrstu = ['centaurs', 'etruscan', 'uncrates']
cceeirsv = ['cervices', 'crevices']
acghinrs = ['chagrins', 'crashing']
accehinr = ['chancier', 'chicaner']
acehprst = ['chapters', 'patchers']
acghimnr = ['charming', 'marching']
acehnsst = ['chastens', 'snatches', 'stanches']
aceehrst = ['cheaters', 'hectares', 'teachers']
cceehkrs = ['checkers', 'rechecks']
ceehilln = ['chenille', 'hellenic']
acdhlnor = ['chlordan', 'chondral']
aceiilst = ['ciliates', 'silicate']
cdeehipr = ['ciphered', 'decipher']
ceirsstu = ['citruses', 'curtsies', 'rictuses']
abcelmrs = ['clambers', 'scramble']
acelpprs = ['clappers', 'scrapple']
acgilnss = ['classing', 'scalings']
aceelnrs = ['cleaners', 'cleanser', 'recleans']
ceeilssv = ['clevises', 'vesicles']
ceiklnrs = ['clinkers', 'crinkles']
bbcelors = ['clobbers', 'cobblers']
celorssu = ['closures', 'sclerous']
accehmno = ['coachmen', 'comanche']
acenorss = ['coarsens', 'narcoses']
aacilott = ['coattail', 'tailcoat']
ceffioru = ['coiffeur', 'coiffure']
acellops = ['collapse', 'escallop']
ciloorst = ['colorist', 'cortisol']
acdeimno = ['comedian', 'demoniac']
cdeilmop = ['compiled', 'complied']
acimnoru = ['conarium', 'coumarin']
ccenoort = ['concerto', 'concreto']
cdinostu = ['conduits', 'discount']
ceefnorr = ['confrere', 'enforcer']
cefinors = ['conifers', 'forensic', 'fornices']
celnooss = ['consoles', 'coolness']
cemnorsu = ['consumer', 'mucrones']
acilnort = ['contrail', 'crotalin']
ceilnopy = ['copyline', 'polyenic']
cenoorrs = ['coroners', 'crooners']
ceorstuy = ['cosurety', 'courtesy']
ccehorsu = ['couchers', 'crouches']
cginorsu = ['coursing', 'scouring']
ceginotv = ['coveting', 'vietcong']
acelrrsw = ['crawlers', 'scrawler']
aceginrs = ['creasing', 'grecians']
aceorrst = ['creators', 'reactors', 'stercora']
cdeiorrt = ['creditor', 'director']
ceirrstt = ['critters', 'restrict', 'stricter']
cginorss = ['crossing', 'scorings']
ceelrstu = ['cruelest', 'lectures']
cemprstu = ['crumpets', 'spectrum']
ceeinpru = ['cupreine', 'precunei']
acemorsy = ['cymarose', 'sycamore']
adeelsst = ['dateless', 'tasseled']
addelrsw = ['dawdlers', 'waddlers']
addeeilr = ['deadlier', 'derailed']
adehinps = ['deanship', 'pinheads']
cdeeeirv = ['deceiver', 'received']
acdegimr = ['decigram', 'grimaced']
acdeeimt = ['decimate', 'medicate']
cdeeilns = ['declines', 'licensed', 'silenced']
cdeeiprt = ['decrepit', 'depicter']
adeeefrt = ['defeater', 'federate']
deefilrs = ['defilers', 'fielders']
deeflorw = ['deflower', 'flowered', 'reflowed']
addeegrr = ['degrader', 'regarded', 'regraded']
deghilst = ['delights', 'slighted']
ddegilnu = ['deluding', 'indulged']
adddeemn = ['demanded', 'maddened']
adeemnor = ['demeanor', 'enamored']
deemrstu = ['demurest', 'mustered']
deemrrru = ['demurrer', 'murderer']
addeeprt = ['departed', 'predated']
deiopsst = ['deposits', 'topsides']
adeeprsv = ['depraves', 'pervades']
adeegnrs = ['deranges', 'grandees', 'grenades']
adeinort = ['deration', 'ordinate', 'rationed', 'rodentia']
deeirrss = ['derrises', 'desirers', 'dressier', 'residers']
cdeeelst = ['deselect', 'selected']
degiinrs = ['desiring', 'residing', 'ringside']
deerssst = ['desserts', 'stressed']
adeeinrt = ['detainer', 'retained']
deiinttu = ['detinuit', 'intuited']
adeinrst = ['detrains', 'randiest', 'residant', 'strained']
adeeistv = ['deviates', 'sedative']
deeinssw = ['dewiness', 'wideness']
acdeimnt = ['dictamen', 'medicant']
deegirst = ['digester', 'redigest']
deioprst = ['diopters', 'topsider']
cdeiorsv = ['discover', 'divorces']
adeeisss = ['diseases', 'seasides']
deeiprss = ['disperse', 'presides']
deioprsv = ['disprove', 'provides']
adeiilrs = ['disraeli', 'railside']
deeirssu = ['diureses', 'reissued', 'residues']
adeimnot = ['dominate', 'nematoid']
adnoorst = ['donators', 'tornados']
acdmnory = ['dormancy', 'mordancy']
denorssu = ['dourness', 'resounds', 'sounders']
addlnoow = ['download', 'woodland']
adefrrst = ['drafters', 'redrafts']
aadeginr = ['drainage', 'gardenia']
dginorsw = ['drowsing', 'wordings']
adeegnru = ['dungaree', 'underage']
ddeilnsw = ['dwindles', 'swindled']
aeehirrt = ['earthier', 'heartier']
ceeginno = ['ecgonine', 'neogenic']
deefiirs = ['edifiers', 'fireside']
acdeortu = ['educator', 'outraced']
eeiinnst = ['einstein', 'nineties']
aceilsst = ['elastics', 'scaliest']
ceelorst = ['electors', 'selector']
eiilsstt = ['elitists', 'siltiest']
aaeemnst = ['emanates', 'manatees']
eiimnoss = ['emission', 'simonies']
acehimpt = ['empathic', 'emphatic']
eelmopry = ['employer', 'reemploy']
aceelnsv = ['enclaves', 'valences']
deenorsw = ['endowers', 'reendows', 'worsened']
aeeenrtv = ['enervate', 'venerate']
aeeglnrs = ['enlarges', 'generals', 'gleaners']
eeeilnst = ['enlistee', 'selenite']
dehnorsu = ['enshroud', 'hounders', 'unhorsed']
aeennrss = ['ensnares', 'nearness']
eeenrrst = ['enterers', 'reenters']
eeilnrty = ['entirely', 'lientery']
ceinootz = ['entozoic', 'enzootic']
aehippst = ['epitaphs', 'happiest']
ceeorrst = ['erectors', 'secretor']
eginprtu = ['erupting', 'reputing']
aeegnrst = ['estrange', 'grantees', 'reagents', 'sergeant', 'tangeres']
eghlooty = ['ethology', 'theology']
aceoortv = ['evocator', 'overcoat']
deeloprx = ['exploder', 'explored']
aefiimrs = ['faireism', 'ramifies']
aabflott = ['faltboat', 'flatboat']
aeefilst = ['fealties', 'leafiest']
eefiirst = ['feistier', 'fieriest']
defhiins = ['fiendish', 'finished']
efhiinrs = ['finisher', 'refinish']
afilnort = ['flatiron', 'inflator']
fgiilnrt = ['flirting', 'trifling']
ffklorsu = ['forkfuls', 'forksful']
aeflmoru = ['formulae', 'fumarole']
aegllssu = ['galluses', 'seagulls']
aegorrrt = ['garroter', 'regrator']
aaegstwy = ['gateways', 'getaways']
aeeglrss = ['gearless', 'largesse']
aeggilnt = ['gelating', 'legating']
aegilnot = ['gelation', 'legation']
aeeegnrt = ['generate', 'teenager']
aegilnor = ['geraniol', 'regional']
aegilmnr = ['germinal', 'malinger']
ggiilnnt = ['glinting', 'tingling']
agilnoss = ['glossina', 'lassoing']
agghinns = ['gnashing', 'hangings']
adgginrs = ['gradings', 'niggards']
aegnrrst = ['granters', 'stranger']
eeghinrs = ['greenish', 'rehinges', 'sheering']
ddegnoru = ['grounded', 'underdog']
egoprrsu = ['groupers', 'regroups']
degnorsu = ['guerdons', 'undergos']
aeginnsu = ['guineans', 'sanguine']
egissttu = ['gustiest', 'gutsiest']
adfhlnsu = ['handfuls', 'handsful']
adhknorw = ['handwork', 'workhand']
adeehknr = ['hankered', 'harkened']
adeehnrr = ['hardener', 'reharden']
aehhrsst = ['harshest', 'thrashes']
aeehnrst = ['hastener', 'heartens']
acehhstt = ['hatchets', 'thatches']
acchkosy = ['haycocks', 'skycoach']
aeghinrs = ['hearings', 'shearing']
eghiinst = ['heisting', 'nighties']
aceehlrs = ['heracles', 'leachers']
dehiills = ['hillside', 'sidehill']
ehiorsst = ['hoisters', 'horsiest']
ehinoppr = ['hornpipe', 'porphine']
ehnrsstu = ['huntress', 'shunters']
ehlrsstu = ['hustlers', 'ruthless']
adeiilms = ['idealism', 'medialis', 'miladies']
adeilort = ['idolater', 'tailored']
eiimmnnt = ['imminent', 'miniment']
aeilmnps = ['impanels', 'maniples']
degiimnp = ['impeding', 'impinged']
iimnprst = ['imprints', 'misprint']
ciiinnos = ['incision', 'inosinic']
deeinnrt = ['indenter', 'interned']
adeinrtu = ['indurate', 'urinated']
defiilns = ['infidels', 'infields']
efgiinnr = ['infringe', 'refining']
afginrst = ['ingrafts', 'strafing']
giiklnns = ['inklings', 'slinking']
ceeinrsu = ['insecure', 'sinecure']
eeinrrst = ['inserter', 'reinsert', 'reinters']
aeilnost = ['insolate', 'toenails']
aeinsstt = ['instates', 'nastiest']
agiilnot = ['intaglio', 'ligation']
eiimnrst = ['interims', 'minister']
einnrstu = ['internus', 'runniest']
eeinnrtv = ['inventer', 'reinvent']
acdilnor = ['ironclad', 'rolandic']
eeinoprs = ['isoprene', 'pioneers']
cehiistt = ['itchiest', 'thecitis', 'theistic']
ceiijstu = ['jesuitic', 'juiciest']
fikklnos = ['kinfolks', 'kinsfolk']
cehiknst = ['kitchens', 'thickens']
abeellrs = ['labelers', 'relabels']
acelorss = ['lacrosse', 'solacers']
abiklmns = ['lambkins', 'lambskin']
aailnstv = ['latvians', 'salivant']
aegilnry = ['layering', 'relaying', 'yearling']
aeelnrrs = ['learners', 'relearns']
eeeilrst = ['leeriest', 'sleetier', 'steelier']
adelorst = ['leotards', 'lodestar']
eeelrrtt = ['letterer', 'reletter']
eegilnrv = ['levering', 'reveling']
aeeilrtv = ['levirate', 'relative']
ceeilnss = ['licenses', 'silences']
eghilrst = ['lighters', 'relights', 'slighter']
deeilrtt = ['littered', 'retitled']
eeilnrsv = ['liveners', 'sniveler']
klooostu = ['lookouts', 'outlooks']
deloorss = ['lordoses', 'odorless']
eelnsttu = ['lunettes', 'unsettle']
aegimrst = ['magister', 'migrates', 'sterigma']
aceilmrt = ['mailcert', 'metrical']
aegimnst = ['mangiest', 'steaming']
aaimnsst = ['mantissa', 'satanism']
aeemrsst = ['masseter', 'steamers']
aeeimnst = ['matinees', 'seminate']
ademnrsu = ['maunders', 'surnamed']
aeemrssu = ['measures', 'reassume']
adeilmst = ['medalist', 'misdealt']
aelmnrsu = ['mensural', 'numerals']
aellmnty = ['mentally', 'tallymen']
aehmoprt = ['metaphor', 'trophema']
aceillmr = ['micellar', 'millrace']
deilmnss = ['mildness', 'mindless']
eilmntuy = ['minutely', 'untimely']
adeimrss = ['misreads', 'sidearms']
eiimmsst = ['mistimes', 'semitism']
deelmors = ['modelers', 'remodels']
ddeelmor = ['moldered', 'remolded']
agmmnoor = ['monogram', 'nomogram']
aeimnors = ['moraines', 'romaines', 'romanies']
eemnsstu = ['muteness', 'tenesmus']
aeilntvy = ['natively', 'venality']
aaegintv = ['navigate', 'vaginate']
eehinprt = ['nephrite', 'trephine']
eeinrstv = ['nerviest', 'reinvest', 'servient']
einorssu = ['neurosis', 'resinous']
ciiknpst = ['nitpicks', 'stickpin']
delnoosu = ['nodulose', 'unloosed']
aailnort = ['notarial', 'rational']
beemnrru = ['numberer', 'renumber']
abeorttu = ['obturate', 'tabouret']
aeeoprst = ['operates', 'petrosae', 'protease']
adilnors = ['ordinals', 'rosalind']
aeilnort = ['oriental', 'relation']
ellosstu = ['outsells', 'sellouts']
ellopstu = ['outspell', 'pollutes']
koorstuw = ['outworks', 'workouts']
adeeorvw = ['overawed', 'reavowed']
aeoprssv = ['overpass', 'passover']
eooprstv = ['overtops', 'stopover']
aeilnpss = ['painless', 'spaniels', 'spinales']
ailmpsst = ['palmists', 'psalmist']
aeilnpst = ['panelist', 'plainest', 'plastein']
aeepprrs = ['paperers', 'prepares']
aaelnprt = ['parental', 'paternal', 'prenatal']
adeelpry = ['parleyed', 'replayed']
aeoprrrt = ['parroter', 'prorater']
aenprsst = ['pasterns', 'raptness']
aeiprsst = ['pastries', 'piasters', 'raspiest', 'traipses']
aioprstt = ['patriots', 'protista']
aenprstt = ['patterns', 'transept']
adeeprst = ['pederast', 'predates']
eegilnps = ['peelings', 'sleeping']
aceelprs = ['percales', 'replaces']
ceefprst = ['perfects', 'prefects']
eenprsst = ['pertness', 'presents', 'serpents']
eeeprrsv = ['perverse', 'preserve']
aeloprst = ['petrosal', 'polestar']
cehilnop = ['phenolic', 'pinochle']
aegillps = ['pillages', 'spillage']
aelnprst = ['planters', 'replants']
aelprstt = ['platters', 'prattles', 'splatter']
aeelprss = ['pleasers', 'relapses']
deinoops = ['poisoned', 'poseidon']
enooprss = ['poorness', 'snoopers']
giinopst = ['positing', 'sopiting']
aloprstu = ['postural', 'pulsator']
eoprrstu = ['posturer', 'troupers']
cdeiprst = ['predicts', 'scripted']
eeimprrs = ['premiers', 'simperer']
eeenprst = ['preteens', 'pretense']
einprrst = ['printers', 'reprints', 'sprinter']
eeimoprs = ['promisee', 'reimpose']
eoprsstt = ['protests', 'spotters']
eprrssuu = ['pursuers', 'usurpers']
aeqrsttu = ['quartets', 'squatter']
eeqrsstu = ['questers', 'requests']
aabeelrt = ['rateable', 'tearable']
aegilnrs = ['realigns', 'signaler', 'slangier']
aceenrst = ['reascent', 'reenacts']
aceenrrt = ['recanter', 'recreant']
cdeeorrr = ['recorder', 'rerecord']
acdeerrt = ['recrated', 'retraced', 'terraced']
ceerrssu = ['recurses', 'rescuers', 'securers']
ceeelrst = ['reelects', 'reselect']
deeiklnr = ['rekindle', 'relinked']
deehilrs = ['relished', 'shielder']
adeeilmr = ['remailed', 'remedial']
egiinnpr = ['repining', 'ripening']
deeiprrs = ['reprised', 'respired']
aceehrrs = ['research', 'searcher']
eeerrrsv = ['reserver', 'reverers', 'reverser']
eiorrsst = ['resistor', 'roisters', 'sorriest']
eeorrrst = ['resorter', 'restorer']
eellprss = ['respells', 'spellers']
aemprsst = ['restamps', 'stampers']
cekorsst = ['restocks', 'stockers']
eginrrst = ['restring', 'stringer']
aeekrrst = ['retakers', 'streaker']
adeehrrt = ['rethread', 'threader']
eeinrstu = ['retinues', 'reunites']
ceehnrrt = ['retrench', 'trencher']
eeirrrst = ['retriers', 'terriers']
eeghirsw = ['reweighs', 'weighers']
agiilnrt = ['ringtail', 'trailing']
agiilnrv = ['rivaling', 'virginal']
einorstu = ['routines', 'rutinose']
ailorsty = ['royalist', 'solitary']
agillnsy = ['sallying', 'signally']
aiirsstt = ['satirist', 'tarsitis']
aeehorss = ['seahorse', 'seashore']
eeghinst = ['seething', 'sheeting']
eelrsstt = ['settlers', 'trestles']
ehorsstu = ['shouters', 'southers']
ggiilnns = ['singling', 'slinging']
giiknrst = ['skirting', 'striking']
eelmrsst = ['smelters', 'termless']
ginnoops = ['snooping', 'spooning']
dginnosu = ['sounding', 'undoings']
aginnpsw = ['spawning', 'wingspan']
eilprstt = ['splitter', 'triplets']
aelrsstt = ['starlets', 'startles']
aprssttu = ['startups', 'upstarts']
ceiklrst = ['stickler', 'ticklers', 'trickles']
ginoppst = ['stopping', 'toppings']
adeirstt = ['striated', 'tardiest']
eipprrst = ['stripper', 'trippers']
glnorsty = ['strongly', 'strongyl']
belmrstu = ['stumbler', 'tumblers', 'tumbrels']
aeeirstw = ['sweatier', 'weariest']
deilnssw = ['swindles', 'wildness', 'windless']
aaegillt = ['talliage', 'telalgia']
cehikstt = ['thickest', 'thickets', 'thickset']
eiinnstt = ['tientsin', 'tinniest']
dehloost = ['toeholds', 'toolshed']
beinrstu = ['tribunes', 'turbines']
bdennruu = ['unburden', 'unburned']
ademnrru = ['underarm', 'unmarred']
adenprsu = ['undrapes', 'unparsed']
adeinpru = ['unpaired', 'unrepaid']
adensttu = ['unstated', 'untasted']
aeellswy = ['walleyes', 'weaselly']
aeehrstw = ['weathers', 'wreathes']
dmooorww = ['woodworm', 'wormwood']
abghinorr = ['abhorring', 'harboring']
abeorsstu = ['abortuses', 'saboteurs']
abbeorrss = ['absorbers', 'reabsorbs']
acceeprst = ['accepters', 'reaccepts']
accdeorrs = ['accorders', 'scorecard']
acceinort = ['accretion', 'anorectic']
aaceinost = ['aconitase', 'caseation']
aacdeittv = ['activated', 'cavitated']
addeerrss = ['addresser', 'readdress']
acdeiilmn = ['adminicle', 'medicinal']
abdginors = ['adsorbing', 'signboard']
aadlortuy = ['adulatory', 'laudatory']
aceeginor = ['aerogenic', 'recoinage']
aeeehsstt = ['aesthetes', 'atheteses']
abiilmnos = ['albinoism', 'binomials']
aaeeiklmu = ['aleukemia', 'leukaemia']
acdegilno = ['algedonic', 'genocidal']
aeeglmort = ['algometer', 'glomerate']
aaeilnort = ['alienator', 'rationale']
aeeiklnss = ['alikeness', 'leakiness']
aeegillrs = ['allergies', 'galleries']
aahllopty = ['allopathy', 'lalopathy']
agillnott = ['allotting', 'totalling']
aadeilmnt = ['almandite', 'laminated']
aabeellrt = ['alterable', 'relatable']
aceiimrst = ['ameristic', 'armistice']
adeeimnst = ['amnestied', 'dementias', 'seminated']
adeimorst = ['amortised', 'mediators']
aemnorstu = ['amounters', 'anoestrum']
aacenrssu = ['anacruses', 'assurance']
aachinrst = ['anarchist', 'cantharis']
acehinort = ['anchorite', 'antechoir']
aciiinpst = ['ancipitis', 'sincipita']
aacegilln = ['angelical', 'galenical']
acceiinrt = ['anicteric', 'circinate']
aaeimnrst = ['animaters', 'marinates']
aeehlnops = ['anopheles', 'phenolase']
adeinostt = ['antidotes', 'stationed']
aeimnrstu = ['antiserum', 'ruminates']
adehioprt = ['aphrodite', 'atrophied']
aaeepprrs = ['appearers', 'reappears']
ainoopprt = ['appointor', 'apportion']
aachirsst = ['archaists', 'catharsis']
aeeginrtt = ['argentite', 'integrate']
aeerrrsst = ['arresters', 'rearrests']
acdeenrss = ['ascenders', 'reascends']
aeginprss = ['aspersing', 'preassign', 'repassing']
aadeiprst = ['aspirated', 'disparate']
aeerrssst = ['asserters', 'reasserts']
aeginssss = ['assessing', 'gassiness']
aginorsst = ['assorting', 'organists']
adeginrst = ['astringed', 'gradients']
aaelmoprt = ['atemporal', 'lepromata']
aceinorst = ['atroscine', 'creations', 'reactions']
aeemprttt = ['attempter', 'reattempt']
aeeimnrtt = ['attermine', 'terminate']
acdeinotu = ['auctioned', 'cautioned', 'education']
aabcdkrsw = ['backwards', 'drawbacks']
aabcelnrs = ['balancers', 'barnacles']
abdeelnor = ['banderole', 'bandoleer']
abeinorst = ['baritones', 'reobtains']
abeeilrst = ['beastlier', 'bleariest', 'liberates']
beggilnno = ['belonging', 'englobing']
abceilnru = ['binuclear', 'incurable']
abehoostu = ['boathouse', 'houseboat']
bdelloors = ['bordellos', 'doorbells']
abeimnrst = ['brainstem', 'tribesman']
abekorstu = ['breakouts', 'outbreaks']
abddeiors = ['broadside', 'sideboard']
befhirrsu = ['brushfire', 'refurbish']
beerrsttu = ['butterers', 'rebutters']
aaceirsst = ['caesarist', 'staircase']
aceilmnsu = ['calumnies', 'masculine']
aceemoprs = ['camporees', 'capsomere']
aceinrsst = ['canisters', 'scenarist']
aceinnors = ['canonries', 'carnosine']
aceginnrt = ['cantering', 'recanting']
aceenorst = ['carotenes', 'censorate']
aacilstuy = ['casuality', 'causality']
aacehinrt = ['catarhine', 'catharine']
accehimst = ['catechism', 'schematic']
aceinostu = ['cautiones', 'tenacious']
acdeeilnn = ['celandine', 'decennial']
aceeelnrt = ['celentera', 'crenelate']
ceginnors = ['censoring', 'reconsign']
aceilnrst = ['centralis', 'cisternal', 'clarinets', 'larcenist']
ceinnortu = ['centurion', 'continuer']
ceefiirrt = ['certifier', 'rectifier']
cdeeirttu = ['certitude', 'rectitude']
acdeehrrt = ['chartered', 'recharted']
acghinrst = ['chartings', 'starching']
cehilorst = ['chlorites', 'clothiers']
achiinrst = ['christian', 'trichinas']
cchiiorrt = ['cirrhotic', 'trichroic']
aabceellr = ['clearable', 'lacerable']
aciilnoot = ['coalition', 'coitional']
aacilostt = ['coattails', 'tailcoats']
cgiinnoot = ['cognition', 'incognito']
ceinorrsu = ['coinsurer', 'recursion']
acdellops = ['collapsed', 'scalloped']
aclloorst = ['collators', 'colostral']
acdeimnop = ['companied', 'compendia']
ccdeenort = ['concerted', 'concreted']
cdeegnost = ['congested', 'decongest']
ceenoqrru = ['conquerer', 'reconquer']
cdeenorsv = ['conserved', 'conversed']
cdeginnos = ['consigned', 'encodings', 'seconding']
acinnorst = ['constrain', 'transonic']
aceinnort = ['container', 'cotarnine', 'crenation', 'narcotine']
acilnnotu = ['continual', 'inoculant']
ceenorrtv = ['converter', 'reconvert']
ceenoortx = ['cortexone', 'neocortex']
cdeenortu = ['countered', 'recounted', 'reductone']
abceelorv = ['coverable', 'revocable']
aceipprst = ['crappiest', 'particeps']
cdeiorrst = ['creditors', 'directors', 'recordist']
ceeilmrss = ['crimeless', 'merciless']
bccemrsuu = ['cucumbers', 'succumber']
ceemortty = ['cytometer', 'metrocyte']
acdeillmy = ['decimally', 'medically']
acdeeimst = ['decimates', 'medicates']
adeeefrst = ['defeaters', 'federates']
adefilnot = ['deflation', 'defoliant']
addeemnrs = ['demanders', 'redemands']
aacdeemrt = ['demarcate', 'macerated']
degimnrru = ['demurring', 'murdering']
adeeenrtv = ['denervate', 'enervated', 'venerated']
cdeennoru = ['denouncer', 'renounced']
adeimnnot = ['dentinoma', 'nominated']
deeilnopt = ['depletion', 'diplotene']
adeginprv = ['depraving', 'pervading']
adegginnr = ['deranging', 'gardening']
deeginrss = ['designers', 'redesigns']
aadeeltuv = ['devaluate', 'evaluated']
adeeimrst = ['diameters', 'dreamiest']
adehiisst = ['diathesis', 'histidase']
abdeiirst = ['diatribes', 'tribadies']
adeiiintt = ['dietitian', 'initiated']
deiinrsst = ['dirtiness', 'disinters']
cddeeinrs = ['discerned', 'rescinded']
dehinosst = ['dishonest', 'hedonists']
deiiorsss = ['disseisor', 'siderosis']
deilosstu = ['dissolute', 'solitudes']
adefilstu = ['disulfate', 'feudalist']
dhinooprs = ['donorship', 'rhodopsin']
dnnorstuw = ['downturns', 'turndowns']
abdeinttu = ['dubitante', 'intubated']
aeghilnrt = ['earthling', 'haltering', 'lathering']
aeegilnnt = ['eglantine', 'inelegant']
ceeeilstv = ['electives', 'selective']
aegimnrst = ['emigrants', 'mastering', 'migrantes', 'streaming']
aegilmntu = ['emulating', 'glutamine']
adeegnnrs = ['endangers', 'greensand']
aeeenrstv = ['enervates', 'venerates']
eeilnrsst = ['enlisters', 'listeners', 'reenlists']
eegilnoos = ['enologies', 'neologies']
aceennrst = ['entrances', 'renascent']
aceeilprs = ['episclera', 'replicase']
ceeinorst = ['erections', 'resection', 'secretion']
ceiimorst = ['eroticism', 'isometric']
ceginorst = ['escorting', 'sectoring']
aeenoprst = ['esperanto', 'operantes', 'personate']
eeoprssss = ['espressos', 'repossess']
aeeimsstt = ['estimates', 'steamiest']
adeilorst = ['estradiol', 'idolaters', 'steroidal']
adehilmot = ['ethmoidal', 'methiodal']
deeiiprsu = ['euripides', 'priedieus']
adeeeglrv = ['everglade', 'leveraged']
beehiirtx = ['exhibiter', 'reexhibit']
adeeituvx = ['exudative', 'exuviated']
aabflostt = ['faltboats', 'flatboats']
aeefnrsst = ['fasteners', 'refastens']
eefiisstt = ['feistiest', 'testifies']
efhiisstt = ['fetishist', 'shiftiest']
efimorrst = ['firestorm', 'reformist', 'restiform']
afilnorst = ['flatirons', 'frontalis']
efgilnorw = ['flowering', 'reflowing']
aeefmnors = ['forenames', 'freemason']
acfilmoru = ['formulaic', 'fumarolic']
dfgilnnou = ['foundling', 'unfolding']
aegginrrt = ['gartering', 'regrating']
aeegilnrs = ['generalis', 'releasing', 'resealing']
eegiinstv = ['genitives', 'ingestive']
egginrstu = ['gesturing', 'grungiest']
adeeginrr = ['grenadier', 'rereading']
acgimnsty = ['gymnastic', 'nystagmic']
aehllorsw = ['hallowers', 'shallower']
aeghiknnr = ['hankering', 'harkening']
ceghinort = ['hectoring', 'trichogen']
ceehiortt = ['heterotic', 'theoretic']
eghiilnrs = ['hirelings', 'relishing']
eehilmost = ['homeliest', 'lithesome']
ehkoorsuw = ['housework', 'workhouse']
acehinrru = ['hurricane', 'raunchier']
egiimmnrs = ['immersing', 'simmering']
aaiilmprt = ['impartial', 'primatial']
eeimprrss = ['impresser', 'simperers']
egimnprsu = ['impugners', 'presuming']
aceinnsst = ['incessant', 'instances']
degiinnnt = ['indenting', 'intending']
efgiinnrr = ['inferring', 'infringer']
efimnorrs = ['informers', 'reinforms']
aeillnrst = ['installer', 'reinstall']
agiilnost = ['intaglios', 'isolating', 'ligations']
eeinrsstt = ['interests', 'resistent', 'triteness']
aeilnrstv = ['intervals', 'ventralis']
aeiimnstt = ['intimates', 'ministate']
degiinrtu = ['intrigued', 'nigritude']
adeinnstu = ['inundates', 'unstained']
eeinnrssv = ['inverness', 'nerviness']
einnoorst = ['ironstone', 'serotonin']
aeeiilrst = ['israelite', 'realities']
acdeiilrv = ['larvicide', 'veridical']
adeelnrru = ['launderer', 'relaunder']
eeghilnrt = ['lengthier', 'lightener']
eeelrrstt = ['letterers', 'reletters']
cegiilnns = ['licensing', 'silencing']
eeilmnost = ['limestone', 'milestone']
eeiilrstz = ['listerize', 'sterilize']
aghloopty = ['logopathy', 'pathology']
abcelrtuu = ['lucubrate', 'tubercula']
aeemnoruv = ['manoeuver', 'manoeuvre']
abgilmnrs = ['marblings', 'ramblings']
aeeimrsst = ['masteries', 'smeariest']
addeemnru = ['maundered', 'undreamed']
eemmnoort = ['metronome', 'monotreme']
aeimnnost = ['minnesota', 'nominates']
eiimnorss = ['missioner', 'remission']
aemnorsty = ['monastery', 'oysterman']
aghmnoopr = ['monograph', 'nomograph', 'phonogram']
aeilmsttu = ['mutilates', 'stimulate', 'ultimates']
aelmnoruy = ['myoneural', 'neuromyal']
acimnorst = ['narcotism', 'romantics']
cemnoorty = ['necrotomy', 'normocyte']
egiinnors = ['nigrosine', 'signorine']
eeinrrssu = ['nurseries', 'reinsures']
ghinnorsu = ['onrushing', 'unhorsing']
aeeoprstt = ['operettas', 'poetaster']
aeiilorst = ['oralities', 'solitaire']
cehiorsst = ['ostriches', 'trichoses']
adeeorrtv = ['overrated', 'overtrade']
enorrstuv = ['overturns', 'turnovers']
aceinopst = ['pactiones', 'stenopaic']
aeeilnpst = ['palestine', 'penalties']
aegilnpry = ['pargyline', 'parleying', 'replaying']
aginoprrt = ['parroting', 'prorating']
aceeinpst = ['patencies', 'pectinase']
adelloprt = ['patrolled', 'portalled']
aceloprst = ['pectorals', 'precostal']
eeinnoprs = ['pensioner', 'perniones']
deefmoprr = ['performed', 'preformed']
aceelprrt = ['perrectal', 'prerectal']
eiinopstt = ['petitions', 'pointiest']
ceiprrstu = ['picturers', 'scripture']
eeloprsty = ['polyester', 'proselyte']
ciilnoptu = ['ponticuli', 'punctilio', 'unpolitic']
ginoprstu = ['posturing', 'sprouting']
ceoprrrsu = ['precursor', 'procurers']
egiimnprs = ['premising', 'simpering']
ceeoprrss = ['prescores', 'reprocess']
eeenprrst = ['presenter', 'repenters', 'represent']
cdeeoprru = ['procedure', 'reproduce']
behilprsu = ['publisher', 'republish']
ceginopry = ['pyrogenic', 'recopying']
aaciilrst = ['racialist', 'satirical']
abelrsttu = ['rebuttals', 'trustable']
ceeorrssu = ['recourses', 'resources']
ceeorrsss = ['recrosses', 'sorceress']
acdenrttu = ['reductant', 'truncated']
adegginrr = ['regarding', 'regrading']
aeeilrstv = ['relatives', 'versatile']
egiinprrs = ['reprising', 'respiring', 'springier']
eeginrstt = ['resetting', 'retesting']
aeinrsstt = ['resistant', 'straitens']
eginorrst = ['resorting', 'restoring']
eginrrsst = ['restrings', 'stringers']
adeehrrst = ['rethreads', 'threaders']
eeenrrsuv = ['revenuers', 'unreserve']
aiinnortu = ['ruination', 'urination']
aeilnssst = ['saltiness', 'stainless']
aceilrstu = ['saluretic', 'sterculia']
aceerrstt = ['scatterer', 'streetcar']
aceilorst = ['sclerotia', 'sectorial']
aegilnrsy = ['searingly', 'yearlings']
ceeennsst = ['senescent', 'sentences']
ceehlprsu = ['sepulcher', 'sepulchre']
egiilnrsv = ['silvering', 'slivering']
eeeilsstt = ['sleetiest', 'steeliest']
aeilnrsst = ['snarliest', 'sternalis']
aenoopsst = ['soapstone', 'teaspoons']
flnoopssu = ['spoonfuls', 'spoonsful']
aeirrsstt = ['starriest', 'traitress']
aeemnsttt = ['statement', 'testament']
aginpprst = ['strapping', 'trappings']
bdennrsuu = ['sunburned', 'unburdens']
deenprssu = ['suspender', 'unpressed']
aeinprrst = ['terrapins', 'transpire']
cehlnostu = ['theloncus', 'unclothes']
acdenrstu = ['transduce', 'underacts']
adeelnrtu = ['unaltered', 'unrelated']
ddeeinrsu = ['underside', 'undesired']
aehinrssv = ['vanishers', 'varnishes']
eefiirrsv = ['verifiers', 'versifier']
abcdeiiort = ['aborticide', 'bacterioid']
aaceinortu = ['acetonuria', 'aeronautic']
aceiimnors = ['acrimonies', 'micronesia']
aaciinottv = ['activation', 'cavitation']
adehimnors = ['admonisher', 'rhamnoside']
adeelrrstu = ['adulterers', 'serrulated']
aabceilnst = ['albicantes', 'blatancies']
aghilmorst = ['algorithms', 'logarithms']
aegillorst = ['allegorist', 'legislator']
agiimnorst = ['amortising', 'migrations']
aceeinrsst = ['ancestries', 'resistance']
adehinorss = ['anhidroses', 'rhodesians']
aaginnostt = ['antagonist', 'stagnation']
aeiimnnost = ['antimonies', 'antinomies', 'semination']
aaginrsttu = ['antitragus', 'saturating']
aeinopprst = ['appointers', 'reappoints']
aceehoprrs = ['archespore', 'reproaches']
aeeginnrst = ['argentines', 'tangerines']
aciinoprst = ['ascription', 'crispation']
aeemprsttt = ['attempters', 'reattempts']
acgiinnotu = ['auctioning', 'cautioning']
abdeelnors = ['banderoles', 'bandoleers', 'endorsable']
abeilmoprt = ['bitemporal', 'importable']
abehoosstu = ['boathouses', 'houseboats']
abeeirrsss = ['brasseries', 'brassieres']
abddeiorss = ['broadsides', 'sideboards']
aaceirssst = ['caesarists', 'staircases']
aceeilnrtv = ['cantilever', 'trivalence']
aacinorstt = ['castration', 'transactio']
aaceglostu = ['catalogues', 'coagulates']
aceinorstu = ['cautioners', 'recusation']
abceeelrst = ['celebrates', 'resectable']
ceinnorstu = ['centurions', 'continuers']
cefgiinrty = ['certifying', 'rectifying']
aceghinrrt = ['chartering', 'recharting']
ceehinrrst = ['christener', 'rechristen']
acgillnops = ['collapsing', 'scalloping']
ceeilmnoss = ['comeliness', 'incomeless']
ceimooprtt = ['competitor', 'optometric']
cdeemoprss = ['compressed', 'decompress']
cefginorsu = ['configures', 'refocusing']
cceennorst = ['connecters', 'reconnects']
ceginnorsv = ['conserving', 'conversing']
ceginnnott = ['contenting', 'contingent']
acceelnosv = ['convalesce', 'covalences']
ceginnortu = ['countering', 'recounting']
aceeilrtvy = ['creatively', 'reactively']
acdeeilnrt = ['credential', 'interlaced']
ccceeinrst = ['crescentic', 'eccentrics']
adeehilprs = ['dealership', 'leadership']
acdeiimnot = ['decimation', 'medication']
cddeinostu = ['deductions', 'discounted']
acdefinort = ['deforciant', 'fornicated']
adeeimnnot = ['denominate', 'emendation']
cdeennorsu = ['denouncers', 'uncensored']
deiinoopst = ['deposition', 'positioned']
cdeeirrstt = ['derestrict', 'restricted']
acdeinortt = ['detraction', 'tetarconid']
aadelrrtux = ['dextraural', 'extradural']
adeilmopst = ['diplomates', 'postmedial']
cdegiinnrs = ['discerning', 'rescinding']
cdeeiorrsv = ['discoverer', 'rediscover']
dehiiinrst = ['disinherit', 'rhinitides']
deiillrsst = ['distillers', 'redistills']
acdeilpstu = ['duplicates', 'spiculated']
aeehilrstt = ['earthliest', 'stealthier']
adeiilorst = ['editorials', 'idolatries']
eefhilnsss = ['elfishness', 'fleshiness']
ccdeinoops = ['endoscopic', 'picosecond']
aeeginnrtv = ['enervating', 'venerating']
aeeinnrstt = ['entertains', 'tenantries']
aeeginnrtt = ['entreating', 'interagent']
aceeilnprt = ['epicentral', 'parentelic']
aeillmopsy = ['episomally', 'polymelias']
aeiinosttv = ['estivation', 'novitiates']
aacehinstu = ['eustachian', 'euthanasic']
beehiirstx = ['exhibiters', 'reexhibits']
deeeiprstx = ['expediters', 'preexisted']
abfimmoory = ['fibromyoma', 'myofibroma']
efgiinprst = ['fingertips', 'presifting']
adeeeggrst = ['gadgeteers', 'segregated']
egilmnooss = ['gloominess', 'neologisms']
acgilorsuy = ['glycosuria', 'graciously']
adeeginnrs = ['grenadines', 'serenading']
aachimnors = ['harmonicas', 'maraschino']
aeeghmnoot = ['hematogone', 'homogenate']
eehmnoorsw = ['homeowners', 'horsewomen']
aeehorssuw = ['housewares', 'warehouses']
ceehnoprty = ['hypocenter', 'nephrocyte']
eimnoprstu = ['importunes', 'resumption']
aceeimprst = ['imprecates', 'spermaceti']
eiimnoprss = ['impression', 'permission']
cdeeiinrst = ['indiscreet', 'indiscrete', 'iridescent']
acfiinnort = ['infarction', 'infraction']
aiinnorstu = ['insinuator', 'ruinations']
eimnnrsttu = ['instrument', 'nutriments']
aceilnrsst = ['interclass', 'larcenists']
adeeilnprt = ['interplead', 'peridental']
deeeinnrtv = ['intervened', 'reinvented']
aehilmorst = ['isothermal', 'thimerosal']
aceelmorst = ['latecomers', 'metacresol']
eegilnrstt = ['letterings', 'resettling']
eeilmnosst = ['limestones', 'milestones']
aaegimrstt = ['magistrate', 'sterigmata']
aaiimnrstu = ['mauritians', 'sanitarium']
aellmopsty = ['meloplasty', 'myeloplast']
aehimpssty = ['metaphysis', 'sympathies']
eemorssttu = ['metestrous', 'metoestrus']
aceimorstt = ['microstate', 'tetrasomic']
deeimnorsz = ['modernizes', 'sermonized']
eiimnoorst = ['monitories', 'moronities']
aciimnorst = ['morticians', 'romanistic']
aiilmnottu = ['mutilation', 'ultimation']
celmoorsty = ['mycosterol', 'sclerotomy']
aceeinnrst = ['nectarines', 'transience']
eghlnoopry = ['nephrology', 'phrenology']
ehmnooprty = ['nephrotomy', 'phonometry']
aiinnorstt = ['nitrations', 'transition']
acgiimnors = ['organicism', 'organismic']
cegilooost = ['osteologic', 'tocologies']
eeikorrstv = ['overstrike', 'strikeover']
acdeiiprst = ['patricides', 'pediatrics']
aceeloprst = ['pectorales', 'percolates']
aceloprstu = ['peculators', 'speculator']
ceinoprssu = ['percussion', 'supersonic']
eemopprrty = ['peremptory', 'preemptory']
cdeeiimprs = ['peridesmic', 'spermicide']
egiinprsst = ['persisting', 'springiest']
eeiinoprtt = ['petitioner', 'repetition']
adeginoprt = ['pignorated', 'readopting']
eillnoopss = ['pollenosis', 'pollinoses']
einooprrst = ['portioners', 'resorption']
aenoopssst = ['postseason', 'soapstones']
eeenprrsst = ['presenters', 'represents']
cdeeoprrsu = ['procedures', 'reproduces']
aeginrrstt = ['registrant', 'restarting']
aeeghinrrs = ['rehearings', 'rehearsing']
adeeinrstt = ['reinstated', 'straitened']
aaeeiprrtt = ['repatriate', 'tertiparae']
aeehnprrss = ['resharpens', 'sharpeners']
aceerrsstt = ['scatterers', 'streetcars']
aeghinrstt = ['shattering', 'straighten']
ghilopsstt = ['spotlights', 'stoplights']
aeemnssttt = ['statements', 'testaments']
aeeilmnrst = ['streamline', 'terminales']
abcellrssu = ['subcellars', 'subscleral']
aabeelmnnu = ['unamenable', 'unnameable']
aceeinrtuv = ['uncreative', 'unreactive']
ddeeinnntu = ['unindented', 'unintended']
ceeeginrtv = ['vicegerent', 'viceregent']
aabceinorst = ['abreactions', 'craniotabes']
aacehioprst = ['acropathies', 'spirochaeta']
adiimnnoost = ['admonitions', 'dominations']
acdeilnorty = ['adrenolytic', 'declinatory']
aaceegillns = ['alcaligenes', 'allegiances']
aegillorsst = ['allegorists', 'legislators']
aadeimnrstv = ['animadverts', 'maidservant']
aceehiilnst = ['antihelices', 'lecithinase']
acdeiiinrst = ['antisideric', 'rancidities']
aceghimnost = ['asthmogenic', 'mesognathic']
aeeilntttvy = ['attentively', 'tentatively']
aeehorssstu = ['authoresses', 'thesauroses']
abdeeiilstz = ['bestialized', 'destabilize']
aacghillpry = ['calligraphy', 'graphically']
aacggilnotu = ['cataloguing', 'coagulating']
acdeinoorrt = ['certiorando', 'recordation']
ceehinrrsst = ['christeners', 'rechristens']
acdeiilnort = ['clitoridean', 'directional']
acceilmopst = ['complicates', 'ectoplasmic']
cddeiinnoot = ['conditioned', 'decondition']
acdeeinorst = ['considerate', 'desecration']
ceennoorrst = ['cornerstone', 'nonsecretor']
cccdiloopsu = ['culdoscopic', 'diplococcus']
cceelmorsty = ['cyclometers', 'sclerectomy']
adeehilprss = ['dealerships', 'leaderships']
acdefiiinot = ['deification', 'edification']
adeeimnnost = ['denominates', 'emendations']
deeiinrsstt = ['dentistries', 'disinterest']
cdeiinoprst = ['description', 'predictions']
abcdeeilnrs = ['discernable', 'rescindable']
cdeinorsstu = ['discounters', 'rediscounts']
aeiilmnorst = ['eliminators', 'normalities']
aehinorrsst = ['enarthrosis', 'nearthrosis']
deeimnoosst = ['endomitoses', 'mesodonties']
aeeilmnnstt = ['entailments', 'sentimental']
eeeinprrsst = ['enterprises', 'intersperse']
aacdeiorrst = ['eradicators', 'radiocaster']
aceghilloot = ['ethological', 'theological']
aefiinnostt = ['festination', 'infestation']
abfimmoorxy = ['fibromyxoma', 'myxofibroma']
aceeggimnot = ['gametogenic', 'gamogenetic', 'geomagnetic']
aeeginnorst = ['generations', 'nitrogenase']
aaegilnrtuv = ['granulative', 'revaluating']
ceehiloprst = ['helicopters', 'lepotriches']
abeghiinnrt = ['hibernating', 'inbreathing']
eghhilosstu = ['houselights', 'lighthouses']
aeeimnoprst = ['impersonate', 'permeations']
beeiilmprss = ['impressible', 'permissible']
aceinooprrt = ['incorporate', 'procreation']
acfiinnorst = ['infarctions', 'infractions']
aeiimnnorst = ['inseminator', 'nitrosamine']
aeegiinrttv = ['integrative', 'vinaigrette']
eeehimnrsst = ['intermeshes', 'smithereens']
eegiinnnrtv = ['intervening', 'reinventing']
acehilmoort = ['lochiometra', 'thoracomeli']
aceeeilmnpt = ['mantelpiece', 'mantlepiece']
aeiiilmnrst = ['matrilinies', 'ministerial']
aeghmnooprr = ['monographer', 'nomographer']
aiilmnosttu = ['mutilations', 'stimulation']
aeilmopssty = ['myoplasties', 'polymasties']
aaaallnopst = ['nasopalatal', 'palatonasal']
aceeinnortv = ['noncreative', 'nonreactive']
aacehinpprr = ['paranephric', 'paraphrenic']
aaeilmnprst = ['parliaments', 'paternalism']
aeenoprrstt = ['paternoster', 'penetrators', 'transportee']
aceilnopstu = ['peculations', 'speculation']
aceeiipprtt = ['peripatetic', 'precipitate']
aeinoprsssu = ['persuasions', 'suspensoria']
aeghopprrty = ['petrography', 'typographer']
aeilmoprrty = ['polarimetry', 'temporarily']
acdeiinoprt = ['predication', 'procidentia']
eeenoprrrst = ['prosternere', 'representor']
acdeilnortu = ['radiolucent', 'reductional']
abceeeilrsv = ['receivables', 'serviceable']
ceeefginnrr = ['referencing', 'refringence']
aceghinoprr = ['renographic', 'reproaching']
eehloprrstu = ['reupholster', 'upholsterer']
aceeirssttt = ['scattersite', 'testatrices']
ceehiknssst = ['sketchiness', 'thicknesses']
aabclprssuu = ['subcapsular', 'subscapular']
cdeefiinrtu = ['uncertified', 'unrectified']
acddeenortu = ['undecorated', 'undercoated']
acceemnorttu = ['accouterment', 'accoutrement']
acdeinooprrt = ['adrenotropic', 'incorporated']
aabeiillrtty = ['alterability', 'bilaterality']
aceehimnoorr = ['amenorrhoeic', 'meconiorrhea']
aaeiilnorstt = ['aristotelian', 'retaliations']
aaceiimnrsst = ['cartesianism', 'sectarianism']
aciiilnoostt = ['coalitionist', 'solicitation']
cdeiimmnooss = ['commissioned', 'decommission']
cdeiinnoorst = ['conditioners', 'reconditions']
acdeilnoosst = ['consolidates', 'disconsolate']
acceinooprtu = ['cornucopiate', 'reoccupation']
aceinnorsttu = ['counterstain', 'encrustation']
abdefiiilnty = ['definability', 'identifiably']
adeeiiloprst = ['depilatories', 'peridiastole']
adeegmmoprrr = ['deprogrammer', 'reprogrammed']
cdeeeinrssst = ['discreetness', 'discreteness']
ceeennorrstu = ['encounterers', 'reencounters']
eegiinnprrst = ['enterprising', 'preinserting']
aeeimnnorstu = ['enumerations', 'mountaineers']
aaeiillmnrtx = ['extraliminal', 'intermaxilla']
abfimmoorsxy = ['fibromyxomas', 'myxofibromas']
adeeimnoprst = ['impersonated', 'predominates']
cdeiiinnorst = ['indirections', 'indiscretion']
aceiilnoprst = ['inspectorial', 'replications']
cdeeiiimorst = ['iridectomies', 'mediocrities']
aceilnooprtt = ['lactoprotein', 'protectional']
aceeeilmnpst = ['mantelpieces', 'mantlepieces']
aaaclmmopsty = ['mycoplasmata', 'plasmacytoma']
eeghilnooprs = ['nephrologies', 'phrenologies']
eehimnooprst = ['nephrotomies', 'phonometries']
aaehinopprst = ['panatrophies', 'siphonaptera']
deegiinoprst = ['predigestion', 'redepositing']
abeinooprrst = ['probationers', 'reabsorption']
aaeiilnorstz = ['rationalizes', 'realizations']
ceeinnoorrst = ['reconnoiters', 'reconnoitres']
aeeghinrrstt = ['restraighten', 'straightener']
eehloprrsstu = ['reupholsters', 'upholsterers']
aeflnoopsstu = ['teaspoonfuls', 'teaspoonsful']
ceeiimorsstv = ['viscometries', 'viscosimeter']
aabdefimnoors = ['adenofibromas', 'fibroadenomas']
aeeeinnsstttv = ['attentiveness', 'tentativeness']
aaadgimoorrtu = ['autoradiogram', 'radioautogram']
abcccceiloruv = ['buccocervical', 'cervicobuccal']
acceehilmoprt = ['cephalometric', 'petrochemical']
aabcceiillorv = ['cervicolabial', 'labiocervical']
acceiilmmorst = ['commercialist', 'microclimates']
aceinnoorsstv = ['conservations', 'conversations']
deeiiinoqrstu = ['derequisition', 'requisitioned']
ceeilmoorssst = ['electrosmosis', 'sclerostomies']
aabfimmoortxy = ['fibromyxomata', 'myxofibromata']
aceghinoprrst = ['gastrophrenic', 'phrenogastric']
ceefiimnoprst = ['imperfections', 'perfectionism']
aeiimnnooprst = ['impersonation', 'semipronation']
aegiiinnosttv = ['investigation', 'tenovaginitis']
eeimmnooostty = ['myotenotomies', 'tenomyotomies']
aaciilloprtty = ['patrilocality', 'patriotically']
aceeiimoppsty = ['pyosepticemia', 'septicopyemia']
aeeghinrrsstt = ['restraightens', 'straighteners']
abccillorstuy = ['scorbutically', 'subcortically']
acefiiinorstv = ['verifications', 'versification']
aabcghiiooprtu = ['autobiographic', 'bioautographic']
accefiiinorstt = ['certifications', 'rectifications']
aaceilnnoorstv = ['conservational', 'conversational']
adegiiinnorstt = ['disintegration', 'disorientating']
eeeiimnprssssv = ['impressiveness', 'permissiveness']
aaeiiilnorttvz = ['relativization', 'revitalization']
cehioooprrssst = ['sporotrichoses', 'trichosporoses']
aaeefhilmnstuz = ['sulfamethazine', 'sulfamezathine']
aaaiimnnnorstt = ['transamination', 'transanimation']
aabeghiiooprstu = ['autobiographies', 'bioautographies']
bceghiilooopssy = ['biopsychologies', 'psychobiologies']
aceeiiklorrsstt = ['keratoscleritis', 'sclerokeratitis']
eegiiilmmnnosty = ['meningomyelitis', 'myelomeningitis']
deeeiilmnorstuy = ['myeloneuritides', 'neuromyelitides']
aghhiloooppstyy = ['pathophysiology', 'physiopathology']
aadeeghiloprrty = ['radiotelegraphy', 'teleradiography']
aacdehiimooprsty = ['cardiomyopathies', 'myocardiopathies']
aceeghhloopprsty = ['glycerophosphate', 'phosphoglycerate']
agghillnnooorryy = ['laryngorhinology', 'rhinolaryngology']
acghhimooopprrst = ['microphotographs', 'photomicrographs']
aeiiiillnopprstt = ['papilloretinitis', 'retinopapillitis']
aghhiiinnoprrsty = ['pharyngorhinitis', 'rhinopharyngitis']
aaadeghiiooprrstu = ['autoradiographies', 'radioautographies']
aceeehiillmnopsty = ['encephalomyelitis', 'myeloencephalitis']
eehhiilmnoooprstt = ['lithonephrotomies', 'nephrolithotomies']
aceghhimooopprrrt = ['microphotographer', 'photomicrographer']
aeghhiiloooppssty = ['pathophysiologies', 'physiopathologies']
aceeehhmmnoooprstu = ['hemopneumothoraces', 'pneumohemothoraces']
aaeeeghllmnooppsty = ['hepatosplenomegaly', 'splenohepatomegaly']
aegghiillnnooorrsy = ['laryngorhinologies', 'rhinolaryngologies']
aacghhiilloooppsty = ['pathophysiological', 'physiopathological']
aceeeghiiilmnnnopst = ['encephalomeningitis', 'meningoencephalitis']
acdeehhmnoooprrstuy = ['hydropneumothoraces', 'pneumohydrothoraces']
aaeeeeghillmnooppsst = ['hepatosplenomegalies', 'splenohepatomegalies']
eeeelmnooooprrsttuyy = ['ureteroneopyelostomy', 'ureteropyeloneostomy']
eeeeeilmnooooprrssttuy = ['ureteroneopyelostomies', 'ureteropyeloneostomies']
