abc = ['abc', 'cab']
ado = ['ado', 'doa']
ago = ['ago', 'gao']
ail = ['ail', 'ali']
abl = ['alb', 'lab']
alp = ['alp', 'lap', 'pal']
amp = ['amp', 'map']
amy = ['amy', 'may', 'yam']
ant = ['ant', 'tan']
aep = ['ape', 'epa', 'pea']
acr = ['arc', 'car']
amr = ['arm', 'mar', 'ram']
ahs = ['ash', 'has']
aet = ['ate', 'eat', 'eta', 'tea']
alw = ['awl', 'law']
aey = ['aye', 'yea']
abg = ['bag', 'gab']
abr = ['bar', 'bra']
bde = ['bed', 'deb']
bey = ['bey', 'bye']
bio = ['bio', 'obi']
bop = ['bop', 'pob']
bdu = ['bud', 'dub']
bru = ['bur', 'rub', 'urb']
btu = ['but', 'tub']
aeijm = ['jamie', 'jamei', 'jaime', 'jaiem']
cit = ['cit', 'tic']
cpu = ['cpu', 'cup']
dei = ['dei', 'die']
den = ['den', 'end']
dim = ['dim', 'mid']
dir = ['dir', 'rid']
dgo = ['dog', 'god']
dos = ['dos', 'sod']
eel = ['eel', 'lee']
eno = ['eon', 'one']
ees = ['ese', 'see']
est = ['est', 'set']
etx = ['ext', 'tex']
fir = ['fir', 'fri']
agm = ['gam', 'mag']
ags = ['gas', 'sag']
egm = ['gem', 'meg']
got = ['got', 'tog']
gtu = ['gut', 'tug']
hot = ['hot', 'tho']
ghu = ['hug', 'ugh']
ins = ['ins', 'sin']
iou = ['iou', 'oui']
irs = ['irs', 'sir', 'sri']
isv = ['ivs', 'vis']
eil = ['lei', 'lie']
elt = ['let', 'tel']
los = ['los', 'sol']
imt = ['mit', 'tim']
ent = ['net', 'ten']
nos = ['nos', 'son']
nov = ['nov', 'von']
aot = ['oat', 'tao']
eor = ['ore', 'reo', 'roe']
apr = ['par', 'rap']
epr = ['per', 'pre', 'rep']
ops = ['pos', 'sop']
psu = ['pus', 'sup', 'ups']
arw = ['raw', 'war']
nru = ['run', 'urn']
cis = ['sci', 'sic']
otw = ['tow', 'two']
awy = ['way', 'yaw']
abbr = ['abbr', 'barb', 'brab']
abde = ['abed', 'bade', 'bead']
abel = ['able', 'bale']
acde = ['aced', 'dace']
aceh = ['ache', 'each', 'haec']
acem = ['acme', 'came', 'mace']
acer = ['acre', 'care', 'cera', 'race']
acst = ['acts', 'cast', 'cats', 'scat']
adds = ['adds', 'dads']
adez = ['adze', 'daze']
aery = ['aery', 'year']
aagr = ['agar', 'raga']
aegr = ['ager', 'gear', 'rage']
aehm = ['ahem', 'haem']
adis = ['aids', 'dais', 'dias', 'said']
ails = ['ails', 'sail']
airs = ['airs', 'sari']
aajr = ['ajar', 'raja']
aabl = ['alba', 'baal']
aagl = ['alga', 'gala']
ailt = ['alit', 'ital', 'lait', 'tail', 'tali']
alms = ['alms', 'slam']
alps = ['alps', 'laps', 'pals', 'slap']
aalt = ['alta', 'lata']
aemn = ['amen', 'mane', 'mean', 'name']
adim = ['amid', 'diam', 'maid']
amps = ['amps', 'maps']
ahkn = ['ankh', 'hank', 'kahn', 'khan']
aans = ['ansa', 'nasa']
anst = ['ants', 'stan', 'tans']
aeps = ['apes', 'apse', 'peas']
acrs = ['arcs', 'cars', 'scar']
adir = ['arid', 'raid']
amry = ['army', 'mary']
arty = ['arty', 'tray']
ahsy = ['ashy', 'hays', 'shay']
asst = ['asst', 'sats']
adlu = ['auld', 'dual', 'laud', 'udal']
aerv = ['aver', 'rave', 'vera']
aisv = ['avis', 'vias', 'visa']
adew = ['awed', 'wade']
answ = ['awns', 'sawn', 'swan']
anox = ['axon', 'noxa']
abgs = ['bags', 'gabs']
abil = ['bail', 'bali']
ablm = ['balm', 'lamb']
abns = ['bans', 'nabs']
aber = ['bare', 'bear', 'brae']
abrs = ['bars', 'bras']
abdu = ['baud', 'daub']
bdes = ['beds', 'debs']
beet = ['beet', 'bete']
best = ['best', 'bets']
beir = ['bier', 'brei', 'brie']
bios = ['bios', 'bois', 'obis']
blow = ['blow', 'bowl']
blru = ['blur', 'burl']
bgos = ['bogs', 'gobs']
belo = ['bole', 'lobe']
bhos = ['bosh', 'hobs']
botu = ['bout', 'tubo']
bcir = ['bric', 'crib']
bdsu = ['buds', 'dubs']
bgru = ['burg', 'grub']
bruy = ['bury', 'ruby']
bssu = ['buss', 'subs']
bsuy = ['busy', 'buys']
acin = ['cain', 'inca']
ackl = ['calk', 'kcal', 'lack']
acms = ['cams', 'scam']
acep = ['cape', 'pace']
acpt = ['capt', 'pact']
acks = ['cask', 'sack']
ceer = ['cere', 'cree']
chin = ['chin', 'inch']
chmu = ['chum', 'much']
cdlo = ['clod', 'cold']
aclo = ['coal', 'cola']
cdeo = ['code', 'coed', 'deco']
cfio = ['coif', 'foci']
cloo = ['colo', 'cool', 'loco']
coop = ['coop', 'poco']
ceop = ['cope', 'opec']
ckor = ['cork', 'rock']
cost = ['cost', 'cots', 'scot']
cosw = ['cows', 'scow']
cdru = ['crud', 'curd']
cdsu = ['cuds', 'scud']
cpsu = ['cups', 'cusp']
adel = ['dale', 'deal', 'lade', 'lead']
ader = ['dare', 'dear', 'read']
adhs = ['dash', 'shad']
adef = ['deaf', 'fade']
deem = ['deem', 'meed']
deer = ['deer', 'reed']
deil = ['deli', 'idle', 'lied']
dens = ['dens', 'ends', 'send']
deny = ['deny', 'dyne']
adil = ['dial', 'laid']
ddio = ['dido', 'oddi']
deis = ['dies', 'ides', 'side']
deir = ['dire', 'ride']
deiv = ['dive', 'vide', 'vied']
deos = ['does', 'dose', 'odes']
delo = ['dole', 'lode']
dlot = ['dolt', 'told']
dino = ['doni', 'nodi', 'odin']
dmoo = ['doom', 'modo', 'mood']
dost = ['dost', 'dots']
adgr = ['drag', 'grad']
adry = ['dray', 'yard']
denu = ['dune', 'nude']
ddey = ['dyed', 'eddy']
aenr = ['earn', 'near']
deen = ['eden', 'need']
eery = ['eery', 'eyer', 'eyre']
eeir = ['eire', 'erie']
aeln = ['elan', 'lane', 'lean']
ells = ['ells', 'sell']
eimt = ['emit', 'item', 'mite', 'time']
emsu = ['emus', 'muse']
egor = ['ergo', 'gore', 'ogre']
ceir = ['eric', 'rice']
eors = ['eros', 'ores', 'roes', 'rose', 'sore']
eess = ['esse', 'sees', 'sese']
eerv = ['ever', 'veer']
eerw = ['ewer', 'were']
aerz = ['ezra', 'raze']
afit = ['fait', 'fiat']
aefr = ['fare', 'fear']
aeft = ['fate', 'feat', 'feta']
eefl = ['feel', 'flee']
efil = ['feil', 'file', 'lief', 'life']
eflt = ['felt', 'left']
efir = ['fire', 'rife']
aefl = ['flea', 'leaf']
fglo = ['flog', 'golf']
eflu = ['flue', 'fuel']
filo = ['foil', 'lifo']
foor = ['foro', 'roof']
frsu = ['furs', 'surf']
agls = ['gals', 'lags', 'slag']
agnt = ['gant', 'gnat', 'tang']
aegp = ['gape', 'page']
agrs = ['gars', 'gras', 'rags']
aghs = ['gash', 'hags', 'shag']
egls = ['gels', 'legs']
dgir = ['gird', 'grid']
eegl = ['glee', 'lege']
gnsu = ['gnus', 'guns', 'snug', 'sung']
gory = ['gory', 'gyro', 'orgy']
goot = ['goto', 'togo']
ginr = ['grin', 'ring']
glpu = ['gulp', 'plug']
gknu = ['gunk', 'kung']
gstu = ['gust', 'guts', 'tugs']
ahil = ['hail', 'hila']
ahlt = ['halt', 'lath']
aehr = ['hare', 'hear', 'rhea']
ahst = ['hast', 'hats']
ahlu = ['haul', 'hula']
ehir = ['heir', 'hire']
ehor = ['hero', 'hoer']
ehsw = ['hews', 'shew']
hilt = ['hilt', 'lith']
hips = ['hips', 'ship']
chko = ['hock', 'koch']
ehos = ['hoes', 'hose', 'shoe']
hops = ['hops', 'hosp', 'posh', 'shop', 'soph']
host = ['host', 'shot']
hnsu = ['huns', 'shun']
hstu = ['huts', 'shut', 'thus', 'tush']
ills = ['ills', 'sill']
aimm = ['imam', 'maim']
inst = ['inst', 'nits', 'tins']
eips = ['ipse', 'pies']
eirs = ['ires', 'rise', 'sire']
eils = ['isle', 'leis', 'lies']
eirt = ['iter', 'reit', 'rite', 'tier', 'tire']
aejn = ['jane', 'jean']
jstu = ['just', 'juts']
aekm = ['kame', 'make']
aknt = ['kant', 'tank']
akoy = ['kayo', 'okay']
eekn = ['keen', 'knee']
eikp = ['kepi', 'pike']
ikln = ['kiln', 'link']
ikps = ['kips', 'skip']
ikst = ['kits', 'skit']
knot = ['knot', 'tonk']
abls = ['labs', 'slab']
ailr = ['lair', 'liar', 'lira', 'rail', 'rial']
almp = ['lamp', 'palm']
aelt = ['late', 'tale', 'teal', 'tela']
alsy = ['lays', 'slay']
aelp = ['leap', 'pale', 'peal', 'plea']
elno = ['leon', 'lone', 'noel']
elst = ['lest', 'lets']
dils = ['lids', 'slid']
illt = ['lilt', 'till']
eilm = ['lime', 'mile']
ilno = ['lion', 'loin', 'noli']
eilr = ['lire', 'reil', 'riel', 'rile']
eilt = ['lite', 'tiel', 'tile']
blos = ['lobs', 'slob']
glos = ['logs', 'slog']
loop = ['loop', 'polo', 'pool']
elop = ['lope', 'pole']
elor = ['lore', 'role']
elov = ['love', 'vole']
elru = ['luer', 'lure', 'rule']
glsu = ['lugs', 'slug']
lstu = ['lust', 'slut']
lnoy = ['lyon', 'only']
acmy = ['macy', 'ymca']
aemr = ['mare', 'ream']
amst = ['mast', 'mats', 'tams']
amsw = ['maws', 'swam']
aems = ['meas', 'mesa', 'same', 'seam']
eimn = ['mein', 'mien', 'mine']
hmos = ['mhos', 'mohs', 'ohms']
eims = ['mise', 'semi']
mnoo = ['mono', 'moon']
moor = ['moor', 'moro', 'room']
amor = ['mora', 'roam']
mnor = ['morn', 'norm']
emot = ['mote', 'tome']
mstu = ['must', 'smut']
aenp = ['nape', 'neap', 'pane']
anry = ['nary', 'yarn']
aenv = ['nave', 'vane', 'vena']
denr = ['nerd', 'rend']
enst = ['nest', 'nets', 'sent', 'tens']
ensw = ['news', 'sewn']
inps = ['nips', 'pins', 'snip', 'spin']
enot = ['note', 'tone']
afos = ['oafs', 'sofa']
aors = ['oars', 'rosa', 'soar']
ilos = ['oils', 'silo', 'soil', 'soli']
hoos = ['oohs', 'shoo', 'soho']
opsu = ['opus', 'soup']
iors = ['oris', 'soir']
loos = ['oslo', 'solo']
ostu = ['oust', 'outs']
eorv = ['over', 'rove']
eosw = ['owes', 'woes']
eory = ['oyer', 'yore']
ainp = ['pain', 'pian']
aepr = ['pare', 'pear', 'rape', 'reap']
aprt = ['part', 'rapt', 'tarp', 'trap']
apss = ['pass', 'saps', 'spas']
aept = ['pate', 'peat', 'tape', 'tepa']
apsy = ['pays', 'spay', 'yaps']
eepr = ['peer', 'pere']
eops = ['peso', 'pose']
epsw = ['pews', 'spew']
ipst = ['pits', 'spit', 'tips']
alpy = ['play', 'pyla']
eopt = ['poet', 'tope']
nopr = ['porn', 'pron']
opru = ['pour', 'roup']
ampr = ['pram', 'ramp']
epry = ['prey', 'pyre']
npsu = ['puns', 'spun']
pstu = ['puts', 'supt']
anrt = ['rant', 'tarn']
aert = ['rate', 'tare', 'tear']
bers = ['rebs', 'serb']
enrt = ['rent', 'tern']
ersu = ['reus', 'rues', 'ruse', 'suer', 'sure', 'user']
hrsu = ['rhus', 'rush']
eirv = ['rive', 'veri', 'vier']
eort = ['rote', 'tore']
ortu = ['rout', 'tour']
nrsu = ['runs', 'urns']
rstu = ['rust', 'ruts']
eers = ['seer', 'sere']
istu = ['situ', 'suit']
nost = ['snot', 'tons']
ipsv = ['spiv', 'vips']
astt = ['stat', 'tats']
estw = ['stew', 'west', 'wets']
essu = ['sues', 'uses']
esuz = ['suez', 'zeus']
ssuu = ['suus', 'usus']
astw = ['swat', 'taws', 'twas', 'wats']
desw = ['swed', 'weds']
ahtw = ['thaw', 'what']
ortt = ['tort', 'trot']
notw = ['town', 'wont']
ailv = ['vail', 'vial']
estv = ['vest', 'vets']
eisv = ['vies', 'vise']
aekw = ['wake', 'weak']
aerw = ['ware', 'wear']
eilw = ['weil', 'wile']
hitw = ['whit', 'with']
aabem = ['abeam', 'ameba']
abelr = ['abler', 'baler', 'blare', 'blear']
abort = ['abort', 'tabor']
abesu = ['abuse', 'beaus']
abcer = ['acerb', 'brace']
aciin = ['acini', 'iniac']
acden = ['acned', 'caned', 'dance']
acers = ['acres', 'cares', 'races', 'scare']
acint = ['actin', 'antic']
adder = ['adder', 'dared', 'dread']
adeem = ['adeem', 'eadem', 'edema']
adept = ['adept', 'taped']
adeor = ['adore', 'oared']
adesz = ['adzes', 'dazes']
aefir = ['afire', 'faire']
aegrs = ['agers', 'gears', 'rages', 'sager', 'sarge']
agist = ['agist', 'gaits']
aeegr = ['agree', 'eager']
aehms = ['ahems', 'shame']
adeis = ['aides', 'aside', 'ideas']
adeim = ['aimed', 'amide', 'media']
aeirs = ['aires', 'aries', 'arise', 'raise']
aalmr = ['alarm', 'malar', 'ramal']
aelrt = ['alert', 'alter', 'later']
aaegl = ['algae', 'galea']
aagls = ['algas', 'galas']
aglor = ['algor', 'largo']
aeiln = ['alien', 'aline', 'anile', 'linea']
allot = ['allot', 'atoll']
aflot = ['aloft', 'float']
aaimn = ['amain', 'amnia', 'anima', 'mania']
abelm = ['amble', 'blame', 'melba']
ademn = ['amend', 'maned', 'named']
agimo = ['amigo', 'imago']
aimno = ['amino', 'animo', 'omnia']
aelmp = ['ample', 'maple']
adens = ['andes', 'danes', 'deans', 'dnase', 'sedan']
aegnr = ['anger', 'range']
agnst = ['angst', 'gnats', 'tangs']
aeinn = ['annie', 'inane']
aaens = ['ansae', 'sanae']
aenst = ['antes', 'nates']
ansty = ['antsy', 'nasty', 'tansy']
aoprt = ['aport', 'porta']
aepss = ['apses', 'passe']
alpty = ['aptly', 'platy']
acder = ['arced', 'cadre', 'cared', 'cedar', 'raced']
agnor = ['argon', 'groan', 'organ']
aegru = ['argue', 'auger', 'rugae']
aemrr = ['armer', 'rearm']
aerrt = ['arret', 'rater', 'terra']
amrsu = ['arums', 'ramus']
acssu = ['ascus', 'casus']
aekrs = ['asker', 'rakes']
aenps = ['aspen', 'napes', 'panes']
aesst = ['asset', 'sates', 'seats']
airst = ['astir', 'sitar', 'stair', 'stria', 'tarsi']
aenot = ['atone', 'oaten']
aartt = ['attar', 'tatar']
anstu = ['aunts', 'tunas']
aertu = ['autre', 'urate']
aertv = ['avert', 'vater']
aenox = ['axone', 'noxae']
abcno = ['bacon', 'banco']
abhst = ['bahts', 'baths']
abinr = ['bairn', 'brain', 'brian']
abeks = ['bakes', 'beaks']
abels = ['bales', 'blase', 'sable']
aabls = ['balsa', 'basal']
abdrs = ['bards', 'brads', 'drabs']
abers = ['bares', 'baser', 'bears', 'braes', 'saber', 'sabre']
abnrs = ['barns', 'brans']
abins = ['basin', 'sabin']
aboss = ['basso', 'bossa']
abdey = ['bayed', 'beady']
abeno = ['beano', 'bonae']
beest = ['beets', 'beset']
beill = ['belli', 'libel']
belst = ['belts', 'blest']
bdeit = ['bidet', 'bited', 'debit']
beirs = ['biers', 'breis']
binos = ['bison', 'bonis', 'nobis']
abelt = ['bleat', 'table']
blost = ['blots', 'bolts']
belru = ['bluer', 'ruble']
blrsu = ['blurs', 'burls']
abost = ['boast', 'boats']
belos = ['boles', 'lobes']
benor = ['boner', 'borne']
bnosu = ['bonus', 'bosun']
beoos = ['boose', 'oboes']
bdeor = ['bored', 'robed']
abdir = ['braid', 'rabid']
aberz = ['braze', 'zebra']
abcor = ['broca', 'carbo', 'carob', 'cobra']
bhort = ['broth', 'throb']
binru = ['bruin', 'rubin']
bhrsu = ['brush', 'shrub']
bdegu = ['budge', 'debug']
bgrsu = ['burgs', 'grubs']
borru = ['burro', 'rubor']
acceh = ['cache', 'chace']
acdit = ['cadit', 'dicta']
acegr = ['cager', 'grace']
acior = ['cairo', 'coria']
aclms = ['calms', 'clams']
acmps = ['camps', 'scamp']
acins = ['canis', 'incas']
aceno = ['canoe', 'ocean']
acdep = ['caped', 'paced']
aceps = ['capes', 'paces', 'scape', 'space']
acert = ['caret', 'carte', 'cater', 'crate', 'creta', 'react', 'recta', 'trace']
acprs = ['carps', 'craps', 'scarp', 'scrap']
acdes = ['cased', 'daces']
acsst = ['casts', 'scats']
acesu = ['cause', 'sauce']
acilv = ['cavil', 'clavi']
censt = ['cents', 'scent']
achmr = ['charm', 'march']
achst = ['chats', 'tachs']
aceht = ['cheat', 'tache', 'teach', 'theca']
cefhi = ['chief', 'fiche']
cehin = ['chine', 'niche']
cehor = ['chore', 'ocher']
cdeir = ['cider', 'cried', 'dicer', 'riced']
cdeit = ['cited', 'edict']
ciilv = ['civil', 'clivi']
acilm = ['claim', 'malic']
aclsy = ['clays', 'scaly']
acelr = ['clear', 'lacer']
cdlos = ['clods', 'colds', 'scold']
cdlou = ['cloud', 'could']
cdeor = ['coder', 'cored', 'credo', 'decor']
cinos = ['coins', 'icons', 'scion', 'sonic']
bcmoo = ['combo', 'coomb']
cloos = ['cools', 'locos']
coost = ['coots', 'scoot']
acopr = ['copra', 'parco']
ceors = ['cores', 'score']
ckory = ['corky', 'rocky']
cnory = ['corny', 'crony']
cosst = ['costs', 'scots']
ceosv = ['coves', 'voces']
acmrs = ['crams', 'scram']
acemr = ['cream', 'macer']
ceert = ['crete', 'erect', 'terce']
ceirs = ['cries', 'rices', 'scire']
ciprs = ['crisp', 'scrip']
celru = ['cruel', 'lucre', 'ulcer']
cersu = ['cruse', 'cures', 'curse']
cffsu = ['cuffs', 'scuff']
cimnu = ['cumin', 'mucin']
bcrsu = ['curbs', 'scrub']
cintu = ['cutin', 'tunic']
adiry = ['dairy', 'diary']
adems = ['dames', 'meads', 'mesad']
aderr = ['darer', 'drear']
adert = ['dater', 'rated', 'tarde', 'tared', 'trade', 'tread']
adisv = ['davis', 'divas', 'vadis']
adelt = ['dealt', 'delta']
acdel = ['decal', 'laced']
deems = ['deems', 'meeds']
adeft = ['defat', 'fated']
defiy = ['deify', 'edify']
deist = ['deist', 'diets', 'edits', 'sited', 'tides']
deimt = ['demit', 'timed']
demos = ['demos', 'domes', 'modes']
deens = ['dense', 'needs']
deopt = ['depot', 'opted', 'toped']
deert = ['deter', 'treed']
deilv = ['devil', 'lived']
aadin = ['diana', 'naiad']
deilt = ['dietl', 'tilde', 'tiled']
dilly = ['dilly', 'idyll']
deins = ['dines', 'snide']
dginy = ['dingy', 'dying']
deirr = ['direr', 'drier', 'rider']
dirst = ['dirts', 'distr']
adinv = ['divan', 'viand']
deisv = ['dives', 'vised']
deost = ['doest', 'dotes']
dloor = ['dolor', 'drool']
doors = ['doors', 'odors', 'roods']
deops = ['dopes', 'posed', 'spode']
adors = ['dorsa', 'roads']
delow = ['dowel', 'lowed']
dorwy = ['dowry', 'rowdy', 'wordy']
denoz = ['dozen', 'zoned']
adekr = ['drake', 'raked']
adrsw = ['draws', 'wards']
ddeir = ['dried', 'redid']
doprs = ['drops', 'prods']
derry = ['dryer', 'redry']
densu = ['dunes', 'nudes']
dsstu = ['dusts', 'studs']
aeegl = ['eagle', 'galee']
aelry = ['early', 'layer', 'relay']
aehrt = ['earth', 'hater', 'heart']
aeers = ['easer', 'erase', 'saree']
adegr = ['edgar', 'garde', 'grade', 'raged']
deegs = ['edges', 'sedge']
eegrt = ['egret', 'greet']
aeelt = ['elate', 'telae']
eilsv = ['elvis', 'evils', 'levis', 'lives', 'veils']
eimst = ['emits', 'items', 'mites', 'smite', 'times']
eemny = ['enemy', 'yemen']
aelnt = ['ental', 'leant']
einos = ['eosin', 'noise']
emops = ['epsom', 'mopes', 'poems']
egort = ['ergot', 'roget', 'tergo']
eopst = ['estop', 'poets', 'stope', 'topes']
eehrt = ['ether', 'there', 'three']
aensv = ['evans', 'naves', 'vanes']
eentv = ['event', 'vente']
aeltx = ['exalt', 'latex']
eopsx = ['expos', 'poxes']
adefr = ['fader', 'fared']
afist = ['faits', 'fiats']
aefls = ['false', 'fleas', 'leafs']
aefst = ['fates', 'feast', 'feats']
afnsu = ['fauns', 'snafu']
eflos = ['felos', 'floes']
efrry = ['ferry', 'fryer', 'refry']
defsu = ['feuds', 'fused']
effis = ['fiefs', 'fifes']
afilr = ['filar', 'flair', 'frail']
efils = ['files', 'flies']
defir = ['fired', 'fried']
efirs = ['fires', 'fries', 'serif']
fisst = ['fists', 'sifts']
filst = ['flits', 'lifts']
floru = ['flour', 'fluor']
eflsu = ['flues', 'fuels', 'fusel']
efgor = ['forge', 'gofer']
forst = ['forts', 'frost']
flosu = ['fouls', 'sulfo']
eefrs = ['frees', 'reefs']
aegls = ['gaels', 'gales']
aegmr = ['gamer', 'marge']
aagmm = ['gamma', 'magma']
adegp = ['gaped', 'paged']
aegps = ['gapes', 'pages']
aegst = ['gates', 'stage']
aegrz = ['gazer', 'graze']
egmno = ['genom', 'gnome']
ghost = ['ghost', 'goths']
ghirt = ['girth', 'right']
aglns = ['glans', 'slang']
eegls = ['glees', 'leges']
aghns = ['gnash', 'hangs']
egnor = ['goner', 'negro', 'regno']
aginr = ['grain', 'nigra']
aegrt = ['grate', 'great', 'greta']
giprs = ['grips', 'prigs', 'sprig']
aglru = ['gular', 'rugal']
gstuy = ['gusty', 'gutsy']
adehs = ['hades', 'heads', 'shade']
aehks = ['hakes', 'shake']
ahlls = ['halls', 'shall']
ahlst = ['halts', 'laths', 'shalt']
ahlpy = ['haply', 'phyla']
ahkrs = ['harks', 'shark']
ahprs = ['harps', 'sharp']
ahlsu = ['hauls', 'hulas']
aehsv = ['haves', 'shave']
aehps = ['heaps', 'phase', 'shape']
eehln = ['helen', 'henle']
ehlot = ['helot', 'hotel']
dehrs = ['herds', 'shred']
ehnor = ['heron', 'honer', 'rhone']
eehrw = ['hewer', 'where']
dehis = ['hides', 'shied']
hills = ['hills', 'shill']
hinst = ['hints', 'thins']
ehlos = ['holes', 'sheol']
ehnos = ['hones', 'shone']
hoops = ['hoops', 'poohs']
ehops = ['hopes', 'phose', 'shope']
hnors = ['horns', 'shorn']
ehoss = ['hoses', 'shoes']
ahmnu = ['human', 'nahum']
hrstu = ['hurts', 'thurs']
deilr = ['idler', 'riled']
egins = ['ignes', 'singe']
deiim = ['imide', 'medii']
ainpt = ['inapt', 'paint', 'pinta']
deinx = ['index', 'nixed']
einnr = ['inner', 'renin']
einst = ['inset', 'stein', 'tines']
einru = ['inure', 'urine']
aeirt = ['irate', 'retia']
ailms = ['islam', 'limas', 'mails']
ailty = ['italy', 'laity']
ajntu = ['jaunt', 'junta']
aekls = ['kales', 'lakes', 'leaks', 'slake']
akrst = ['karst', 'karts', 'stark']
aekst = ['keats', 'skate', 'stake', 'steak', 'takes', 'teaks']
eekns = ['keens', 'knees', 'skene']
eikps = ['kepis', 'pikes', 'spike']
iklns = ['kilns', 'links', 'slink']
eikln = ['kline', 'liken']
iknst = ['knits', 'stink']
iknos = ['kosin', 'oinks']
kooty = ['kyoto', 'tokyo']
acels = ['laces', 'scale']
ailrs = ['lairs', 'liars', 'liras', 'rails', 'rials']
aelmr = ['lamer', 'realm']
almps = ['lamps', 'palms', 'plasm', 'psalm']
ailnp = ['lapin', 'plain']
aalpp = ['lappa', 'papal']
alsst = ['lasts', 'salts', 'slats']
aalsv = ['lavas', 'vasal']
alnwy = ['lawny', 'wanly']
aelpt = ['leapt', 'petal', 'plate', 'pleat']
aelst = ['least', 'setal', 'slate', 'stale', 'steal', 'tales', 'teals']
elmno = ['lemon', 'melon']
eelpr = ['leper', 'repel']
elptu = ['letup', 'tuple']
eilsw = ['lewis', 'wiles']
eilns = ['liens', 'lines']
gilno = ['ligon', 'lingo']
bilmo = ['limbo', 'mobil']
ilmos = ['limos', 'moils']
gilns = ['lings', 'sling']
ilpss = ['lisps', 'slips']
eilrt = ['liter', 'relit', 'tiler']
eilrv = ['liver', 'viler']
delno = ['loden', 'olden']
eloss = ['loess', 'loses', 'soles']
lmoos = ['looms', 'osmol']
loops = ['loops', 'pools', 'sloop', 'spool']
delop = ['loped', 'poled']
elors = ['loser', 'roles']
elosu = ['louse', 'seoul']
alsuu = ['luaus', 'usual']
lmpsu = ['lumps', 'plums', 'slump']
alnru = ['lunar', 'ulnar']
delru = ['lured', 'ruled']
lsstu = ['lusts', 'sluts']
elrsy = ['lyres', 'slyer']
achmo = ['macho', 'mocha']
adims = ['maids', 'midas']
allms = ['malls', 'small']
amnor = ['manor', 'norma', 'roman']
aemrs = ['mares', 'maser', 'reams', 'smear']
amnos = ['mason', 'moans', 'monas']
ademt = ['mated', 'tamed']
aemst = ['mates', 'meats', 'steam', 'tames', 'teams']
aemnt = ['meant', 'menta']
elmst = ['melts', 'smelt']
eemns = ['mesne', 'semen']
eimns = ['miens', 'mines']
eimrx = ['mixer', 'remix']
imost = ['moist', 'omits']
mnoos = ['moons', 'nomos']
emopy = ['mopey', 'myope']
emors = ['mores', 'morse']
emost = ['motes', 'smote', 'tomes']
emorv = ['mover', 'vomer']
cmoru = ['mucor', 'mucro']
emrsu = ['muser', 'serum']
ailns = ['nails', 'sinal', 'slain', 'snail']
anssu = ['nasus', 'susan']
eginr = ['negri', 'niger', 'reign']
enops = ['nepos', 'opens', 'peons', 'pones']
eenrv = ['nerve', 'never']
ensuv = ['nevus', 'venus']
ensux = ['nexus', 'unsex']
inssu = ['nisus', 'sinus']
denos = ['nodes', 'nosed']
enors = ['norse', 'snore']
alnot = ['notal', 'talon', 'tonal']
enost = ['notes', 'onset', 'seton', 'steno', 'stone', 'tones']
denru = ['nuder', 'under']
aeoss = ['oases', 'ossea']
deilo = ['oiled', 'oldie']
eilov = ['olive', 'voile']
ciopt = ['optic', 'picot', 'topic']
eiors = ['osier', 'rosie']
eortt = ['otter', 'torte', 'toter']
eortu = ['outer', 'outre', 'route', 'utero']
eorsv = ['overs', 'roves', 'servo', 'verso']
elotw = ['owlet', 'towel']
ainps = ['pains', 'spain', 'spina']
adelp = ['paled', 'pedal', 'plead']
alpsy = ['palsy', 'plays', 'pylas', 'splay']
aeprr = ['parer', 'raper']
akprs = ['parks', 'spark']
aiprt = ['parti', 'tapir']
aeprv = ['parve', 'paver']
apsst = ['pasts', 'spats']
ahpst = ['paths', 'staph']
anpsw = ['pawns', 'spawn']
aekps = ['peaks', 'speak']
deips = ['pedis', 'spied']
eenps = ['peens', 'penes', 'pense']
elpst = ['pelts', 'slept', 'spelt']
einps = ['penis', 'pines', 'snipe', 'spine']
eilpr = ['peril', 'plier']
epsst = ['pests', 'steps']
eoprt = ['petro', 'toper', 'trope']
eiprs = ['piers', 'pries', 'spire']
eilps = ['piles', 'plies', 'spiel']
inopt = ['pinto', 'piton', 'point']
lopsy = ['ploys', 'polys']
ekops = ['pokes', 'spoke']
eoprs = ['pores', 'poser', 'prose', 'ropes', 'spore']
oprsu = ['porus', 'pours']
opstu = ['pouts', 'spout']
aprsy = ['prays', 'raspy', 'spray']
eprsy = ['preys', 'pyres']
eiprr = ['prier', 'riper']
iprsu = ['prius', 'sirup']
aopss = ['psoas', 'sapos', 'soaps']
eepru = ['puree', 'rupee']
eprsu = ['purse', 'sprue', 'super']
diqsu = ['quids', 'squid']
ioqtu = ['quito', 'quoit']
anrst = ['rants', 'tarns', 'trans']
aelrv = ['ravel', 'velar']
bersu = ['rebus', 'rubes']
deery = ['redye', 'reedy']
cehir = ['reich', 'riche']
enrst = ['rents', 'stern', 'terns']
eorsw = ['resow', 'sower', 'swore', 'worse']
errty = ['retry', 'terry']
eilrs = ['riels', 'riles', 'slier']
eirss = ['rises', 'sires']
ailrv = ['rival', 'viral']
aorst = ['roast', 'taros']
oorst = ['roost', 'roots', 'torso']
eorsu = ['roues', 'rouse']
nrstu = ['runts', 'turns']
rsstu = ['rusts', 'truss']
inrtu = ['rutin', 'turin']
aelss = ['sales', 'seals']
arsty = ['satyr', 'stray', 'trays']
aessv = ['saves', 'vases']
aersw = ['sawer', 'swear', 'wares', 'wears']
eersv = ['serve', 'sever', 'veers', 'verse']
epstu = ['setup', 'upset']
ahmss = ['shams', 'smash']
hopss = ['shops', 'sophs']
ginss = ['signs', 'sings']
ilsty = ['silty', 'styli']
iknss = ['sinks', 'skins']
isstu = ['situs', 'suits']
aekns = ['snake', 'sneak']
anpss = ['snaps', 'spans']
noops = ['snoop', 'spoon']
ooprs = ['sopor', 'spoor']
ilpst = ['spilt', 'split']
aklst = ['stalk', 'talks']
aknst = ['stank', 'tanks']
arstt = ['start', 'tarts']
aestv = ['stave', 'vesta']
ffist = ['stiff', 'tiffs']
instt = ['stint', 'tints']
ekost = ['stoke', 'tokes']
osttu = ['stout', 'touts']
arstw = ['straw', 'swart', 'warts']
rsttu = ['strut', 'trust']
ginsu = ['suing', 'using']
egrsu = ['surge', 'urges']
apssw = ['swaps', 'wasps']
ahstw = ['swath', 'thaws']
eepsw = ['sweep', 'weeps']
illsw = ['swill', 'wills']
eipsw = ['swipe', 'wipes']
acett = ['tacet', 'tecta']
aertt = ['tater', 'teart', 'treat']
eenst = ['teens', 'tense']
enstu = ['tenus', 'tunes', 'unset']
hortw = ['throw', 'worth']
eirtt = ['titer', 'titre', 'trite']
opsty = ['topsy', 'typos']
eortw = ['tower', 'wrote']
ailrt = ['trail', 'trial']
isttw = ['twist', 'twits']
eintu = ['unite', 'untie']
aeluv = ['uveal', 'value']
einsv = ['veins', 'vines', 'visne']
giorv = ['vigor', 'virgo']
ailov = ['viola', 'voila']
adelw = ['waled', 'weald']
aprsw = ['warps', 'wraps']
deirw = ['weird', 'wider', 'wired']
deinw = ['widen', 'wined']
eirrw = ['wirer', 'wrier']
abdeis = ['abides', 'biased']
abeltu = ['ablute', 'betula']
abdeos = ['abodes', 'adobes']
abeqsu = ['absque', 'basque']
aacdir = ['acarid', 'cardia']
acehir = ['achier', 'archei']
aacinr = ['acinar', 'arnica', 'carina', 'crania']
aceors = ['acrose', 'coarse']
acinot = ['action', 'atonic', 'cation']
acertu = ['acuter', 'cauter', 'curate']
addels = ['addles', 'saddle']
adeehr = ['adhere', 'header']
adistu = ['aditus', 'audits']
addeor = ['adored', 'deodar']
adeors = ['adores', 'soared']
abderv = ['adverb', 'braved']
aeeirs = ['aeries', 'easier']
adefil = ['afield', 'failed']
aaegsv = ['agaves', 'savage']
aaglno = ['agonal', 'analog', 'angola']
aeegrr = ['agreer', 'regear']
adeirs = ['aiders', 'raised', 'redias']
aeimrs = ['aimers', 'armies']
aaimnr = ['airman', 'marian', 'marina']
aeilss = ['aisles', 'lassie']
acelov = ['alcove', 'coeval']
adeflr = ['alfred', 'flared']
aeilns = ['aliens', 'saline']
aeilrt = ['aliter', 'litera', 'retail', 'retial', 'tailer']
allost = ['allots', 'atolls']
aellru = ['allure', 'laurel']
almost = ['almost', 'stomal']
aacels = ['alsace', 'scalae']
aeelrt = ['altere', 'relate']
ailmnu = ['alumni', 'lumina']
abdelm = ['ambled', 'bedlam', 'beldam', 'blamed', 'lambed']
abelms = ['ambles', 'blames']
adeemn = ['amende', 'demean']
adeims = ['amides', 'medias', 'mesiad']
aelmpr = ['ampler', 'emparl', 'palmer']
aacmrt = ['amtrac', 'tarmac']
aemssu = ['amuses', 'assume']
achnor = ['anchor', 'archon', 'charon']
adenrs = ['anders', 'sander', 'snared']
adenrw = ['andrew', 'wander', 'warden', 'warned']
aeglns = ['angels', 'angles', 'gleans']
adegln = ['angled', 'dangle', 'lagend']
aglnos = ['anglos', 'slogan']
aailmn = ['animal', 'lamina', 'malian', 'manila']
aeinss = ['anises', 'sanies', 'sansei', 'sasine']
ainnot = ['anoint', 'nation']
aehmnt = ['anthem', 'mentha']
aelnrt = ['antler', 'learnt', 'rental']
aceips = ['apices', 'spicae']
anoprs = ['aprons', 'parson']
acginr = ['arcing', 'caring', 'racing']
adenrt = ['ardent', 'ranted']
aegnrt = ['argent', 'garnet']
aegrsu = ['argues', 'augers']
aeirss = ['arises', 'raises']
agimnr = ['arming', 'margin']
adlnor = ['arnold', 'ronald']
aerrst = ['arrest', 'rarest', 'raster', 'raters', 'starer']
airstt = ['artist', 'strait', 'traits']
acenst = ['ascent', 'enacts', 'secant', 'stance']
aahmns = ['ashman', 'shaman']
aahmrs = ['ashram', 'marsha']
agikns = ['asking', 'gaskin']
acipss = ['aspics', 'spicas']
aensst = ['assent', 'sanest']
aessss = ['assess', 'sasses']
aissst = ['assist', 'stasis']
aenrst = ['astern', 'sterna']
aehnst = ['athens', 'hasten']
adenot = ['atoned', 'donate']
aciopt = ['atopic', 'pactio']
aarstt = ['attars', 'strata']
aailsv = ['avails', 'saliva', 'salvia']
aeinnv = ['avenin', 'vienna']
adiinv = ['avidin', 'vidian']
aginnw = ['awning', 'waning']
abegls = ['bagels', 'gables']
abinrs = ['bairns', 'brains']
abeirt = ['baiter', 'barite']
abdelr = ['balder', 'blared']
abelrs = ['balers', 'blares', 'blears']
aabmnt = ['bantam', 'batman']
abelry = ['barely', 'barley', 'bleary']
abdekr = ['barked', 'braked', 'debark']
abelsy = ['basely', 'belays']
abesst = ['basset', 'bastes', 'beasts']
abeltt = ['battle', 'tablet']
abders = ['beards', 'breads', 'debars']
bdeims = ['bedims', 'imbeds']
beirtu = ['beirut', 'biuret']
behrst = ['berths', 'herbst']
beirst = ['bestir', 'biters', 'tribes']
beillr = ['biller', 'rebill']
bdeinr = ['binder', 'inbred', 'rebind']
biorst = ['bistro', 'orbits']
belorw = ['blower', 'bowler']
abelot = ['boatel', 'lobate', 'oblate']
abgoot = ['bogota', 'tobago']
bbdemo = ['bombed', 'mobbed']
bdeort = ['bordet', 'debtor']
beosss = ['bosses', 'obsess']
belosw = ['bowels', 'elbows']
abdirs = ['braids', 'disbar']
abersz = ['brazes', 'zebras']
bbdeir = ['bribed', 'ribbed']
abdilr = ['bridal', 'ribald']
befirs = ['briefs', 'febris', 'fibers']
bhorst = ['broths', 'throbs']
berstu = ['brutes', 'buster', 'rebuts', 'tubers']
beffru = ['buffer', 'rebuff']
beglru = ['bugler', 'burgle']
bdeknu = ['bunked', 'debunk']
bdestu = ['busted', 'debuts']
acdest = ['cadets', 'casted']
acders = ['cadres', 'cedars', 'sacred', 'scared']
aacimn = ['caiman', 'maniac']
aceklr = ['calker', 'clarke']
acllsu = ['callus', 'sulcal']
acelms = ['camels', 'mescal']
acdeln = ['candle', 'lanced']
acenrs = ['caners', 'cranes']
acdeno = ['canoed', 'deacon']
acdent = ['canted', 'decant']
acnort = ['cantor', 'carton', 'contra', 'craton']
aacnsv = ['canvas', 'vacans']
acoprt = ['captor', 'cartop']
aceenr = ['careen', 'crenae']
acerss = ['caress', 'crases', 'scares']
aclors = ['carols', 'corals']
acdepr = ['carped', 'redcap']
acnorr = ['carron', 'rancor']
acdert = ['carted', 'crated', 'traced']
acerrt = ['carter', 'crater', 'tracer']
acerrv = ['carver', 'craver']
aceins = ['casein', 'incase']
acehss = ['cashes', 'chases']
aaclsu = ['casual', 'causal']
acersu = ['causer', 'saucer']
aacetv = ['caveat', 'vacate']
aceisv = ['cavies', 'vesica']
cdeent = ['cedent', 'decent']
cellos = ['cellos', 'colles']
cenors = ['censor', 'crones']
aceert = ['cerate', 'cetera', 'create']
ceersu = ['cereus', 'ceruse', 'recuse', 'rescue', 'secure']
ceimru = ['cerium', 'uremic']
ceerss = ['cesser', 'recess']
acehlt = ['chalet', 'thecal']
achnst = ['chants', 'snatch', 'stanch']
acehst = ['chaste', 'cheats', 'sachet', 'scathe', 'taches']
cehsty = ['chesty', 'scythe']
ccehil = ['chicle', 'cliche']
cefhis = ['chiefs', 'fiches']
ccehio = ['choice', 'echoic']
chinop = ['chopin', 'phonic']
chimrs = ['chrism', 'smirch']
cceilr = ['circle', 'cleric']
ceiist = ['cities', 'iciest']
cinort = ['citron', 'cortin', 'crotin']
ceistv = ['civets', 'evicts']
acelns = ['cleans', 'lances']
cdeilo = ['cleoid', 'coiled', 'docile']
aciilt = ['clitia', 'italic']
celors = ['closer', 'cresol']
celorv = ['clover', 'velcro']
cdeors = ['coders', 'credos', 'scored']
ceehor = ['cohere', 'echoer', 'reecho']
ceinor = ['coiner', 'orcein', 'recoin']
celoor = ['colore', 'cooler']
ccimos = ['comics', 'cosmic']
cimoty = ['comity', 'myotic']
cdnoor = ['condor', 'cordon']
cdeloo = ['cooled', 'locoed']
ceopss = ['copses', 'scopes']
cdeorr = ['corder', 'record']
cdekor = ['corked', 'docker', 'rocked']
acnoor = ['corona', 'racoon']
ceinos = ['cosine', 'oscine']
ceorsu = ['course', 'source']
ceinov = ['covine', 'novice']
ceooty = ['coyote', 'oocyte']
acdenr = ['craned', 'dancer']
acekrs = ['creaks', 'sacker']
cdeirt = ['credit', 'direct']
ceimnr = ['crimen', 'mincer']
acirst = ['crista', 'racist']
cerstu = ['cruets', 'eructs', 'rectus', 'truces']
crstuy = ['crusty', 'curtsy']
cdipsu = ['cupids', 'cuspid']
cerrsu = ['curers', 'curser', 'recurs']
cosstu = ['custos', 'scouts']
ademno = ['daemon', 'moaned']
adeggr = ['dagger', 'ragged']
adempr = ['damper', 'ramped']
admnos = ['damson', 'monads', 'nomads']
addeln = ['dandle', 'landed']
adeiln = ['daniel', 'denial', 'nailed']
adeppr = ['dapper', 'rapped']
adelnr = ['darnel', 'lander']
addert = ['darted', 'reddat', 'traded']
adinrw = ['darwin', 'inward']
adehrs = ['dasher', 'shader', 'shared']
aderst = ['daters', 'stader', 'stared', 'sterad', 'trades', 'treads']
addelw = ['dawdle', 'waddle']
adefly = ['deafly', 'flayed']
adeerr = ['dearer', 'reader', 'reared', 'reread']
adehrt = ['dearth', 'hatred', 'thread']
acdels = ['decals', 'scaled']
cdeeer = ['decree', 'recede']
deeepr = ['deeper', 'peered']
adefkl = ['defalk', 'flaked']
defmor = ['deform', 'formed']
dehnor = ['dehorn', 'horned']
cdeeir = ['deicer', 'dicere']
deisst = ['deists', 'desist']
addeel = ['delead', 'leaded']
ddeelu = ['delude', 'dueled', 'eluded']
ddeein = ['denied', 'indeed']
deeins = ['denies', 'seined']
deenrs = ['denser', 'enders', 'resend', 'sender']
deenst = ['dentes', 'nested', 'tensed']
ddeenu = ['denude', 'endued']
adeprt = ['depart', 'parted', 'petard', 'prated']
deenop = ['depone', 'opened']
deopst = ['depots', 'despot', 'posted', 'ptosed']
adeert = ['derate', 'teared']
deerst = ['desert', 'deters', 'rested']
adeilt = ['detail', 'dilate', 'tailed']
deortu = ['detour', 'redout', 'routed', 'toured']
deestv = ['devest', 'vested']
ddeiov = ['devoid', 'voided']
deeotv = ['devote', 'vetoed']
demorw = ['deworm', 'wormed']
addeil = ['dialed', 'laddie']
bbdeil = ['dibble', 'libbed']
ddeios = ['didoes', 'diodes']
ddeeit = ['dieted', 'edited']
deffir = ['differ', 'riffed']
deimmr = ['dimmer', 'rimmed']
adinrs = ['dinars', 'drains', 'nadirs']
deilop = ['diploe', 'dipole', 'peloid']
deirst = ['direst', 'driest', 'sterid', 'stride']
dehiss = ['dishes', 'hissed']
deilps = ['dispel', 'lisped']
adinsv = ['divans', 'viands']
degglo = ['dogleg', 'logged']
dloors = ['dolors', 'drools']
deiopr = ['dopier', 'period']
adegot = ['dotage', 'togaed']
deortt = ['dotter', 'rotted']
delosw = ['dowels', 'slowed']
denorw = ['downer', 'wonder']
adeprr = ['draper', 'parred']
adepry = ['drapey', 'prayed']
degoru = ['drogue', 'gourde', 'rouged']
ddenor = ['droned', 'nodder']
deprsu = ['drupes', 'dupers', 'prudes', 'pursed']
bbderu = ['dubber', 'rubbed']
defflu = ['duffel', 'duffle', 'luffed']
derstu = ['duster', 'rudest', 'rusted']
admnoy = ['dynamo', 'monday']
aeflru = ['earful', 'ferula']
aeenrr = ['earner', 'nearer']
aehrty = ['earthy', 'hearty']
aeerss = ['easers', 'erases']
aceilr = ['eclair', 'lacier']
deinos = ['edison', 'noised']
adderw = ['edward', 'warded']
egiost = ['egoist', 'gestio']
eghhit = ['eighth', 'height']
aeelst = ['elates', 'teasel']
eilors = ['elisor', 'oilers', 'oriels']
aeeltu = ['eluate', 'luteae']
beilmo = ['emboli', 'mobile']
deimno = ['emodin', 'monied']
aeelmn = ['enamel', 'melena']
deginn = ['ending', 'ginned']
denosw = ['endows', 'snowed']
deenru = ['endure', 'enured']
deflno = ['enfold', 'fondle']
aegimn = ['enigma', 'gamine']
aeegnr = ['enrage', 'genera']
aeilnt = ['entail', 'tineal']
eeinrt = ['entire', 'teneri']
eeenrt = ['entree', 'tenere']
aenprw = ['enwrap', 'pawner']
eilpsu = ['epulis', 'pileus']
eipqsu = ['equips', 'piques']
beimru = ['erbium', 'imbrue']
deeors = ['erodes', 'redoes']
eprstu = ['erupts', 'purest']
einoss = ['essoin', 'noesis', 'noises', 'ossein']
eehrst = ['esther', 'ethers', 'threes']
emrstu = ['estrum', 'muster']
cehist = ['ethics', 'itches']
eenstv = ['events', 'steven']
ceeinv = ['evince', 'venice']
aelstx = ['exalts', 'lastex', 'laxest']
eisstx = ['exists', 'sexist']
aacfis = ['facias', 'fascia']
aefkrs = ['fakers', 'freaks']
acflno = ['falcon', 'flacon']
adefmr = ['farmed', 'framed']
aefrst = ['faster', 'strafe']
aefsst = ['feasts', 'safest']
efinst = ['feints', 'finest', 'infest']
efirrs = ['ferris', 'firers']
eefrst = ['fester', 'freest']
efilrs = ['filers', 'fliers', 'lifers', 'rifles']
efillr = ['filler', 'refill']
definr = ['finder', 'friend']
defikn = ['finked', 'knifed']
defist = ['fisted', 'sifted']
deflow = ['flowed', 'fowled']
eflntu = ['fluent', 'unfelt']
aeflot = ['foetal', 'folate']
deflor = ['folder', 'refold']
eforst = ['forest', 'fortes', 'foster', 'softer']
efmorr = ['former', 'reform']
afirry = ['friary', 'rarify']
abeglr = ['gabler', 'garble']
adeggt = ['gadget', 'tagged']
aegirt = ['gaiter', 'triage']
aeegmt = ['gamete', 'metage']
adghin = ['gandhi', 'hading']
aegprs = ['gapers', 'grapes', 'pagers']
aeggrt = ['garget', 'tagger']
aegrrt = ['garret', 'garter', 'grater']
aegllu = ['gaulle', 'ullage']
aegiln = ['genial', 'linage']
eegnrs = ['genres', 'greens']
degnru = ['gerund', 'nudger']
aginst = ['giants', 'sating']
degilr = ['gilder', 'girdle', 'glider', 'regild']
ddegir = ['girded', 'ridged']
aeglrs = ['glares', 'lagers']
glmosu = ['glomus', 'moguls']
egilru = ['gluier', 'uglier']
eginss = ['gneiss', 'singes']
adegrr = ['grader', 'regard']
aeggnr = ['grange', 'nagger']
agnors = ['groans', 'organs', 'sarong']
egorss = ['grosse', 'ogress']
egorrw = ['grower', 'regrow']
gnrstu = ['grunts', 'strung']
aaginu = ['guiana', 'iguana']
aeehrs = ['haeres', 'hearse']
aehilt = ['halite', 'thelia']
aehlrt = ['halter', 'lather']
aeghnr = ['hanger', 'rehang']
aehnns = ['hansen', 'hennas']
aehhrs = ['hasher', 'rehash']
aehrtt = ['hatter', 'threat']
aehnsv = ['havens', 'shaven']
aeehrr = ['hearer', 'rehear']
aehhst = ['heaths', 'sheath']
cehort = ['hector', 'tocher', 'troche']
ehisst = ['heists', 'shiest', 'thesis']
eehinr = ['herein', 'inhere']
ehnors = ['herons', 'honers', 'nosher']
ehikrs = ['hikers', 'shriek', 'shrike']
hippsu = ['hippus', 'uppish']
ehilrt = ['hitler', 'lither']
dhlopu = ['holdup', 'uphold']
ehnort = ['hornet', 'throne']
dhnosu = ['hounds', 'hudson', 'unshod']
ehorsv = ['hovers', 'shover']
dehlru = ['hurdle', 'hurled']
ehlrtu = ['hurtle', 'luther']
acceip = ['icecap', 'ipecac']
diimos = ['idioms', 'iodism']
deilst = ['idlest', 'listed', 'silted', 'tildes']
egiint = ['ignite', 'tieing']
ailmpr = ['imparl', 'primal']
eimpru = ['impure', 'umpire']
ceinst = ['incest', 'insect', 'nicest', 'scient']
eginst = ['ingest', 'signet', 'tinges']
eiknrs = ['inkers', 'sinker']
adinor = ['inroad', 'ordain']
aeimns = ['inseam', 'semina']
eilnos = ['insole', 'lesion']
einpst = ['instep', 'neptis', 'spinet']
einrsu = ['insure', 'inures', 'ursine']
einorr = ['ironer', 'renoir']
eimors = ['isomer', 'rimose']
eirssu = ['issuer', 'uresis']
cdiiox = ['ixodic', 'oxidic']
ajnstu = ['jaunts', 'juntas']
cdeiju = ['judice', 'juiced']
ceiklt = ['keltic', 'tickle']
eiklrt = ['kilter', 'kirtle']
eikrss = ['kisser', 'skiers']
chikst = ['kitsch', 'shtick']
abeill = ['labile', 'liable']
addelr = ['ladder', 'larded']
aelmnt = ['lament', 'mantel', 'mantle', 'mental']
aailms = ['lamias', 'salami']
aeklnr = ['lanker', 'rankle']
aelprs = ['lapser', 'pearls']
aaclrs = ['lascar', 'rascal', 'sacral', 'scalar']
ahilst = ['latish', 'tahsil']
achlnu = ['launch', 'nuchal']
aelrsy = ['layers', 'relays', 'slayer']
alotuy = ['layout', 'outlay']
adeelp = ['leaped', 'pealed']
adeels = ['leased', 'sealed']
aeelrv = ['leaver', 'reveal']
deeelr = ['leered', 'reeled']
elmnos = ['lemons', 'melons', 'solemn']
eillnt = ['lentil', 'lintel']
elorss = ['lessor', 'losers']
elpstu = ['letups', 'tuples']
eeelsv = ['levees', 'sleeve']
eeilrv = ['levier', 'relive', 'revile']
deeilr = ['lieder', 'relied']
eilnor = ['lienor', 'neroli']
ghilst = ['lights', 'slight']
eiklns = ['likens', 'silken']
eilmnr = ['limner', 'merlin']
eilnpu = ['lineup', 'lupine', 'unpile']
eilprs = ['lisper', 'perils', 'pilers', 'pliers']
chiilt = ['litchi', 'lithic']
eilnsv = ['livens', 'snivel']
eilrvy = ['livery', 'verily']
aelnor = ['loaner', 'reloan']
eilort = ['loiter', 'toiler']
deloos = ['loosed', 'oodles', 'soloed']
eloort = ['looter', 'tooler']
eloppr = ['lopper', 'propel']
elossu = ['louses', 'soleus', 'uloses']
ellovy = ['lovely', 'volley']
elorsw = ['lowers', 'slower']
bbelru = ['lubber', 'rubble']
eilntu = ['luetin', 'lutein']
delmpu = ['lumped', 'plumed']
gilnru = ['luring', 'ruling']
elmtuu = ['luteum', 'mutuel']
aadmru = ['madura', 'maraud']
adeilm = ['mailed', 'medial']
aeimrt = ['maitre', 'metria']
aaelmt = ['malate', 'meatal', 'tamale']
aeegmn = ['manege', 'menage']
aemnss = ['manses', 'mensas']
aimnst = ['mantis', 'matins']
aimost = ['maoist', 'taoism']
aemppr = ['mapper', 'pamper']
aekmrr = ['marker', 'remark']
adehms = ['mashed', 'shamed']
aemqsu = ['masque', 'squame']
agimnt = ['mating', 'taming']
amorsy = ['mayors', 'morays']
aemstu = ['meatus', 'mutase']
deemnr = ['mender', 'remend']
emnort = ['mentor', 'termon']
eimrst = ['merits', 'mister', 'miters', 'remits', 'smiter', 'timers']
ddeimn = ['midden', 'minded']
eimmrs = ['mimers', 'simmer']
iimoss = ['miosis', 'omissi']
deilms = ['misled', 'slimed', 'smiled']
almors = ['molars', 'morals']
elmost = ['molest', 'motels']
demoor = ['moored', 'roomed']
emossy = ['moseys', 'myoses']
eemorv = ['movere', 'remove']
emrssu = ['musers', 'serums']
immstu = ['mutism', 'summit']
imnosy = ['myosin', 'simony']
aeinrv = ['naiver', 'ravine']
abelnu = ['nebula', 'unable']
deentt = ['netted', 'tented']
eenrtu = ['neuter', 'tenure', 'tureen']
eiinss = ['niseis', 'seisin']
einors = ['noires', 'nosier', 'senior']
ginnot = ['noting', 'toning']
dintuy = ['nudity', 'untidy']
egmntu = ['nutmeg', 'tugmen']
affopy = ['offpay', 'payoff']
enosst = ['onsets', 'stenos', 'stones']
aeoprs = ['operas', 'soaper']
einops = ['opines', 'ponies']
aeoptt = ['optate', 'teapot']
ginopt = ['opting', 'toping']
eopssu = ['opuses', 'spouse']
eosssu = ['osseus', 'souses']
ehorst = ['others', 'throes']
cenosu = ['ounces', 'unesco']
opttuu = ['output', 'putout']
acekpr = ['packer', 'repack']
alprty = ['paltry', 'partly', 'raptly']
annpsu = ['pannus', 'unsnap']
anprty = ['pantry', 'trypan']
aeprrs = ['parers', 'parser', 'rapers', 'rasper', 'sparer']
aelpry = ['parley', 'pearly', 'player', 'replay']
aeprrt = ['parter', 'prater']
adepss = ['passed', 'spades']
ailpst = ['pastil', 'plaits', 'spital']
ahopst = ['pathos', 'potash']
aloprt = ['patrol', 'portal']
aeprsy = ['payers', 'repays']
acehpr = ['percha', 'preach']
eeprsu = ['peruse', 'purees', 'rupees']
eipsst = ['pestis', 'spites']
aehprs = ['phaser', 'phrase', 'seraph', 'shaper', 'sherpa']
hilops = ['philos', 'polish']
ceeips = ['pieces', 'specie']
ilopst = ['pilots', 'pistol', 'spoilt']
inopst = ['pintos', 'piston', 'pitons', 'points']
aeiprt = ['pirate', 'pretia']
ailnps = ['plains', 'spinal']
aelnpr = ['planer', 'replan']
alpsty = ['plasty', 'platys']
eiopss = ['poises', 'posies']
loppsy = ['polyps', 'sloppy']
ginopr = ['poring', 'roping']
eoprss = ['posers', 'spores']
eoprst = ['poster', 'presto', 'repost', 'topers', 'tropes']
ceiprs = ['precis', 'prices']
aeprrw = ['prewar', 'rewrap', 'warper']
eiprrs = ['priers', 'sprier']
inprst = ['prints', 'sprint']
deopsu = ['pseudo', 'souped']
einpru = ['punier', 'purine', 'unripe']
iprstu = ['purist', 'turpis']
ainqtu = ['quaint', 'quanti']
illqsu = ['quills', 'squill']
eiqrsu = ['quires', 'risque', 'squire']
eoqrtu = ['quoter', 'torque']
acekrt = ['racket', 'tacker']
ailmru = ['ramuli', 'rimula', 'uramil']
aeiprr = ['rapier', 'repair']
aehrrs = ['rasher', 'sharer']
aiorst = ['ratios', 'satori']
adertt = ['ratted', 'tetrad']
alrtty = ['rattly', 'tartly']
aelrsv = ['ravels', 'salver', 'slaver']
adeemr = ['reamed', 'remade']
deeerv = ['reeved', 'veered']
eefilr = ['refile', 'relief']
eginrs = ['reigns', 'resign', 'signer', 'singer']
ceilrs = ['relics', 'slicer']
aemorr = ['remora', 'roamer']
ellorr = ['reroll', 'roller']
eellrs = ['resell', 'seller']
eirsst = ['resist', 'sister']
delors = ['resold', 'solder']
eorssw = ['resows', 'sowers']
aeinrt = ['retain', 'retina']
eerstt = ['retest', 'setter', 'street', 'tester']
eorrtu = ['retour', 'router']
eeirvw = ['review', 'viewer']
aemrrw = ['rewarm', 'warmer']
ekorrw = ['rework', 'worker']
einprs = ['ripens', 'sniper']
eirstv = ['rivets', 'strive']
oorsst = ['roosts', 'torsos']
dnortu = ['rotund', 'untrod']
eorrsu = ['rouser', 'sourer']
abmrsu = ['rumbas', 'umbras']
aberss = ['sabers', 'sabres']
addens = ['sadden', 'sanded']
ainsst = ['saints', 'satins', 'stains']
aelssv = ['salves', 'slaves', 'valses']
aeenst = ['sateen', 'senate']
aaprst = ['satrap', 'sparta']
aiorsv = ['savior', 'savoir']
anostx = ['saxton', 'taxons']
eeinrs = ['seiner', 'serine']
enorss = ['sensor', 'snores']
deersv = ['served', 'versed']
epsstu = ['setups', 'upsets']
ehinrs = ['shiner', 'shrine']
ehorsw = ['shower', 'whores']
deilss = ['sidles', 'slides']
eirstt = ['sitter', 'titers']
aekrst = ['skater', 'streak', 'takers']
aelsst = ['slates', 'stales', 'steals', 'tassel']
eelsty = ['sleety', 'steely']
loopss = ['sloops', 'spools']
aeknss = ['snakes', 'sneaks']
noopss = ['snoops', 'spoons']
ennost = ['sonnet', 'tenons']
eorsst = ['sorest', 'stores']
ghostu = ['sought', 'toughs']
opsstu = ['spouts', 'tossup']
oprstu = ['sprout', 'stupor']
adestt = ['stated', 'tasted']
aiostt = ['statio', 'taoist']
aeinst = ['stenia', 'tenias', 'tisane']
eilstt = ['stilet', 'titles']
aosstt = ['stoats', 'toasts']
ainrst = ['strain', 'trains']
eorstv = ['strove', 'troves', 'voters']
rssttu = ['struts', 'trusts']
ablsuy = ['suably', 'usably']
eisstu = ['suites', 'tissue']
epprsu = ['supper', 'uppers']
erstuu = ['suture', 'uterus']
aesstw = ['sweats', 'wastes']
amnopt = ['tampon', 'topman']
aeerrt = ['tearer', 'terrae']
eesstt = ['testes', 'tsetse']
horstw = ['throws', 'worths']
deiltt = ['tilted', 'titled']
cinost = ['tocsin', 'tonics']
dioprt = ['torpid', 'tripod']
orsttu = ['trouts', 'tutors']
ginrtu = ['truing', 'turing']
enrstu = ['tuners', 'unrest']
einrtw = ['twiner', 'winter']
innosu = ['unions', 'unison']
einstu = ['unites', 'unties']
aelstv = ['valets', 'vestal']
elosvw = ['vowels', 'wolves']
aeirvw = ['waiver', 'wavier']
eiklnw = ['welkin', 'winkle']
eirstw = ['wriest', 'writes']
aacinor = ['aaronic', 'conaria', 'ocarina']
abeortt = ['abettor', 'taboret']
abdeort = ['aborted', 'borated']
aborstu = ['abortus', 'tabours']
abdegir = ['abridge', 'brigade']
aabinst = ['abstain', 'bastian']
aaacinr = ['acarina', 'acrania']
aacclru = ['accrual', 'caracul']
abcceir = ['acerbic', 'breccia']
acciort = ['acrotic', 'carotic']
acinost = ['actions', 'cations', 'scotian']
aaclstu = ['actuals', 'scatula']
aadmnos = ['adamson', 'damnosa']
addeehr = ['adhered', 'redhead']
adeehrs = ['adheres', 'headers', 'sheared']
adeimrr = ['admirer', 'married']
adeoprt = ['adopter', 'readopt']
adeersv = ['adverse', 'evaders']
aderstv = ['adverts', 'starved']
aaginst = ['against', 'agitans', 'signata']
aeegrrs = ['agreers', 'greaser', 'regears']
aeilmnt = ['ailment', 'aliment']
agiinrs = ['airings', 'arising', 'raising']
aailnot = ['alation', 'laotian']
acegllo = ['alcogel', 'collage']
adeelrt = ['alerted', 'altered', 'related', 'treadle']
aeilrst = ['aletris', 'realist', 'retails', 'saltier']
adegiln = ['aligned', 'dealing', 'leading']
aegllry = ['allergy', 'gallery', 'largely', 'regally']
aellrsu = ['allures', 'laurels']
aelorst = ['altrose', 'oestral']
abelmrs = ['amblers', 'blamers', 'marbles', 'rambles']
abemnos = ['ambones', 'bemoans']
aeimnty = ['amenity', 'anytime']
acdeemr = ['amerced', 'creamed']
aimnnos = ['amnions', 'mansion', 'mansoni', 'onanism']
aemrssu = ['amusers', 'erasmus', 'masseur']
aaenpst = ['anapest', 'peasant']
aceinns = ['anciens', 'canines']
aeinrst = ['anestri', 'nastier', 'retains', 'retinas', 'stainer', 'stearin']
aeeglns = ['angeles', 'senegal']
adeegnr = ['angered', 'derange', 'enraged', 'grandee', 'grenade']
aeginrr = ['angrier', 'earring', 'rangier', 'rearing']
aiimnst = ['animist', 'intimas']
aeklnst = ['anklets', 'lankest']
adeilnn = ['annelid', 'lindane']
aelnnru = ['annuler', 'unlearn']
acimnos = ['anosmic', 'masonic']
aeginnt = ['anteing', 'antigen', 'gentian']
acehimp = ['aphemic', 'impeach']
adenpps = ['appends', 'snapped']
acioprt = ['apricot', 'parotic']
abinrtu = ['arbutin', 'tribuna']
acehrrs = ['archers', 'crasher']
acghinr = ['arching', 'chagrin']
aimprst = ['armpits', 'imparts']
aacinrs = ['arnicas', 'carinas', 'sarcina']
aceinrs = ['arsenic', 'carnies']
aceilrt = ['article', 'recital']
aainrst = ['artisan', 'sinatra', 'tsarina']
aelrsst = ['artless', 'lasters', 'salters']
acensst = ['ascents', 'secants', 'stances']
acciist = ['ascitic', 'sciatic']
adeiprs = ['aspired', 'despair', 'diapers', 'praised']
aginsss = ['assigns', 'sassing']
aaeirst = ['asteria', 'atresia', 'setaria']
acimost = ['atomics', 'comitas', 'maticos', 'osmatic', 'somatic']
aeinost = ['atonies', 'estonia']
aaeimrt = ['atremia', 'materia']
aceirtt = ['atretic', 'cattier', 'citrate', 'teratic']
aensttu = ['attunes', 'tetanus']
acorstu = ['auctors', 'surcoat']
aeegnrv = ['avenger', 'engrave']
abbbdel = ['babbled', 'blabbed']
abeggrs = ['baggers', 'beggars']
abdelst = ['baldest', 'blasted', 'stabled']
abelltu = ['ballute', 'bullate']
aabmnst = ['bantams', 'batsman']
abbelrs = ['barbels', 'rabbles', 'slabber']
abgiknr = ['barking', 'braking']
abinost = ['bastion', 'obtains']
abeirtt = ['battier', 'biretta']
abelrsw = ['bawlers', 'warbles']
abddeer = ['bearded', 'breaded']
abeerst = ['beaters', 'berates', 'rebates']
bdeeors = ['bedsore', 'sobered']
beeefir = ['beefier', 'freebie']
abegiln = ['belgian', 'bengali']
abdeert = ['berated', 'debater', 'rebated']
beeegis = ['beseige', 'besiege']
abeilst = ['bestial', 'stabile']
bddeeit = ['betided', 'debited']
bdeinrs = ['binders', 'rebinds']
abilopr = ['bipolar', 'parboil']
abelrst = ['blaster', 'stabler']
beilrst = ['blister', 'bristle']
bbbdelo = ['blobbed', 'bobbled']
bdelott = ['blotted', 'bottled']
bdelosu = ['bloused', 'doubles']
belorsw = ['blowers', 'bowlers']
bbbelru = ['blubber', 'bubbler']
behlssu = ['blushes', 'bushels']
abddeor = ['boarded', 'roadbed']
abeorst = ['boaster', 'boaters', 'borates']
belorst = ['bolster', 'lobster']
abdegno = ['bondage', 'dogbane']
bdeloru = ['boulder', 'doubler']
abeillr = ['braille', 'liberal']
abeirss = ['braises', 'brassie']
abelrrw = ['brawler', 'warbler']
bbgiinr = ['bribing', 'ribbing']
bilorst = ['bristol', 'strobil']
abcksuw = ['bucksaw', 'sawbuck']
beglrsu = ['buglers', 'burgles']
bdeilru = ['builder', 'rebuild']
bllosuu = ['bullous', 'lobulus']
accehst = ['cachets', 'catches']
accdekl = ['cackled', 'clacked']
aacimns = ['caimans', 'maniacs']
aaclmsu = ['calamus', 'maculas']
abceilr = ['caliber', 'calibre']
acellrs = ['callers', 'cellars', 'recalls', 'scleral']
aaclrvy = ['calvary', 'cavalry']
aacelmr = ['cameral', 'caramel']
aacdeln = ['canaled', 'candela']
acennrs = ['canners', 'scanner']
achnstu = ['canthus', 'staunch']
aacelnu = ['canulae', 'lacunae']
acilopt = ['capitol', 'optical', 'placito', 'topical']
aaclpsu = ['capsula', 'scapula']
acinopt = ['caption', 'paction', 'pontiac']
acderrs = ['carders', 'scarred']
acegors = ['cargoes', 'corsage', 'socager']
acelorr = ['caroler', 'correal']
aaclprs = ['carpals', 'scalpra']
aceprrs = ['carpers', 'scarper', 'scraper']
aceirrs = ['carries', 'scarier']
acerrst = ['carters', 'craters', 'tracers']
acerrsv = ['carvers', 'cravers']
acehrss = ['cashers', 'chasers', 'crashes']
acckoss = ['cassock', 'cossack']
acdeert = ['catered', 'created', 'decreta', 'reacted']
aciltty = ['cattily', 'tacitly']
acginsu = ['causing', 'saucing']
aceilrv = ['caviler', 'clavier', 'valeric']
ceilssu = ['celsius', 'sluices']
acenrtu = ['centaur', 'uncrate']
aceinrt = ['ceratin', 'certain']
ceeinrs = ['ceresin', 'sincere']
cefirty = ['certify', 'rectify']
acdeost = ['cestoda', 'coasted']
acehlst = ['chalets', 'latches', 'satchel']
accehnr = ['chancer', 'chancre']
acehnrt = ['chanter', 'tranche']
acehlrs = ['charles', 'larches']
acehmrr = ['charmer', 'marcher']
acehrrt = ['charter', 'rechart']
aceehrt = ['cheater', 'hectare', 'reteach', 'teacher']
cceehkr = ['checker', 'recheck']
cehiils = ['chilies', 'helicis']
cehkors = ['chokers', 'shocker']
acehlor = ['cholera', 'chorale', 'choreal']
cdeehor = ['chordee', 'cohered']
chlosuy = ['chylous', 'slouchy']
ceiinss = ['cinesis', 'iciness', 'incises']
ceinrst = ['cistern', 'cretins']
aciortt = ['citator', 'ricotta']
aceilmr = ['claimer', 'miracle', 'reclaim']
acilnor = ['clarion', 'conrail']
aceelnr = ['cleaner', 'reclean']
acdeelr = ['cleared', 'declare']
ceiklnr = ['clinker', 'crinkle']
bbcelor = ['clobber', 'cobbler']
celopsu = ['closeup', 'couples']
aceilmn = ['cnemial', 'melanic']
acginot = ['coating', 'cognati']
ccikloy = ['cockily', 'colicky']
ceffors = ['coffers', 'scoffer']
ceehors = ['coheres', 'echoers']
ciilost = ['colitis', 'solicit']
celoorr = ['colorer', 'recolor']
ceilmop = ['compile', 'polemic']
accilno = ['conical', 'laconic']
cnoortu = ['contour', 'crouton']
celoors = ['coolers', 'creosol']
cginops = ['copings', 'scoping']
ceoprst = ['copters', 'prosect']
acdeort = ['cordate', 'redcoat']
cekorrs = ['corkers', 'rockers']
cgiknor = ['corking', 'rocking']
acnoors = ['coronas', 'racoons']
ceoprss = ['corpses', 'process']
cginost = ['costing', 'gnostic']
cenortu = ['counter', 'recount', 'trounce']
cdeorsu = ['coursed', 'scoured']
ceorssu = ['courses', 'rescous', 'sources', 'sucrose']
acefrrt = ['crafter', 'refract']
aceerst = ['creates', 'secreta']
cceehrs = ['creches', 'screech']
cdeirst = ['credits', 'directs']
cimnors = ['crimson', 'microns']
ceorrss = ['crosser', 'recross', 'scorers']
celrtuy = ['cruelty', 'cutlery']
acerstu = ['crustae', 'curates', 'sucrate']
ceiprtu = ['cuprite', 'picture']
cersttu = ['curtest', 'cutters']
acepstu = ['cuspate', 'teacups']
ccdiloy = ['cyclodi', 'cycloid']
adeiils = ['dailies', 'liaised']
addeill = ['dallied', 'dialled']
adeills = ['dallies', 'sallied']
addeinr = ['dandier', 'drained']
addegln = ['dangled', 'gladden']
adelpps = ['dapples', 'slapped']
adelnrs = ['darnels', 'landers', 'slander', 'snarled']
adeinrr = ['darrein', 'drainer', 'randier']
adginrt = ['darting', 'trading']
adeistv = ['datives', 'devisat', 'vistaed']
adddelw = ['dawdled', 'waddled']
addelsw = ['dawdles', 'swaddle', 'waddles']
adeefst = ['deafest', 'defeats', 'feasted']
adeenry = ['deanery', 'yearned']
abdeess = ['debases', 'seabeds']
cddeeir = ['decider', 'decried']
cddeeer = ['decreed', 'receded']
cdeeert = ['decreet', 'erected']
ddeimsu = ['dedimus', 'muddies']
cddeesu = ['deduces', 'seduced']
deeepst = ['deepest', 'steeped']
adefint = ['defiant', 'fainted']
deefilr = ['defiler', 'fielder', 'refiled']
deefinr = ['definer', 'refined']
deforst = ['defrost', 'frosted']
deefiis = ['deifies', 'edifies']
deeirst = ['deiters', 'diester', 'dieters', 'reedits', 'steride']
adeelry = ['delayer', 'layered', 'relayed']
deghilt = ['delight', 'lighted']
deeilrv = ['deliver', 'livered', 'relived', 'reviled']
deeimrt = ['demerit', 'merited']
ddeeims = ['demised', 'misdeed']
deinsty = ['density', 'destiny']
deinstt = ['dentist', 'distent', 'stinted']
adeprst = ['departs', 'petards']
deenopr = ['deponer', 'reponed']
ddeeops = ['deposed', 'seedpod']
deiopst = ['deposit', 'dopiest', 'posited', 'sopited', 'topside']
deeprss = ['depress', 'pressed']
adeilrs = ['derails', 'dialers']
ddeeirs = ['derides', 'desired', 'resided']
deersst = ['deserts', 'dessert']
deeirrs = ['desirer', 'dreiser', 'redries', 'resider', 'serried']
deilops = ['despoil', 'dipoles', 'soliped', 'spoiled']
adeilst = ['details', 'dilates']
adeinrt = ['detrain', 'trained']
deiorsv = ['devisor', 'devoirs', 'visored', 'voiders']
adgiiln = ['dialing', 'gliadin']
adeinox = ['diaxone', 'dioxane']
dgiinty = ['dignity', 'tidying']
degilns = ['dingles', 'singled']
adeeiss = ['disease', 'seaside']
deillps = ['dispell', 'spilled']
deinsst = ['dissent', 'snidest']
deiostt = ['dittoes', 'testoid']
deirstv = ['diverts', 'strived']
cdekost = ['dockets', 'stocked']
degiklo = ['doglike', 'godlike']
adnoort = ['donator', 'odorant', 'tornado']
admnort = ['dormant', 'mordant']
deinoru = ['dourine', 'neuroid']
denorsw = ['downers', 'wonders']
deorssw = ['dowsers', 'drowses']
adegnrt = ['dragnet', 'granted']
aderrsw = ['drawers', 'redraws', 'rewards', 'warders']
aadegry = ['drayage', 'yardage']
deerrss = ['dresser', 'redress']
degorsu = ['drogues', 'gourdes', 'groused']
deelrsu = ['duelers', 'eluders']
deimmsu = ['dummies', 'mediums']
acdenru = ['durance', 'uncared']
dersstu = ['dusters', 'trussed']
admnosy = ['dynamos', 'mondays']
aeelrss = ['earless', 'leasers', 'resales', 'reseals', 'sealers']
aeginnr = ['earning', 'engrain', 'grannie', 'nearing']
aeehnrt = ['earthen', 'hearten', 'teheran']
aeginst = ['eatings', 'ingesta', 'seating', 'teasing']
deiorst = ['editors', 'oestrid', 'steroid', 'storied', 'triodes']
ceiikst = ['ekistic', 'ickiest']
aeelpss = ['elapses', 'pleases']
aegilnt = ['elating', 'gelatin', 'genital']
aceelrt = ['electra', 'treacle']
eilnotu = ['elution', 'outline']
deeemrs = ['emersed', 'redeems']
aeeimrt = ['emirate', 'meatier']
eemorst = ['emoters', 'meteors']
eeimprs = ['empires', 'premise', 'spireme']
eimnopt = ['emption', 'pimento']
aemnors = ['enamors', 'oarsmen']
aceelnv = ['enclave', 'levance', 'valence']
deginns = ['endings', 'sending']
deenrsu = ['endures', 'ensured']
deeginr = ['energid', 'reigned']
eeginns = ['engines', 'senegin']
aegmnrs = ['engrams', 'germans', 'mangers']
eejnory = ['enjoyer', 'reenjoy']
eilnsst = ['enlists', 'listens']
eginnss = ['ensigns', 'sensing']
aeelnsv = ['enslave', 'leavens']
eeenrrt = ['enterer', 'reenter']
ceinopt = ['entopic', 'nepotic']
aacelpt = ['epactal', 'placate']
aegimpr = ['epigram', 'primage']
eeilpst = ['epistle', 'septile']
aeginrs = ['erasing', 'gainers', 'regains', 'searing']
eimorst = ['erotism', 'moister', 'mortise']
deeprtu = ['erupted', 'reputed']
eikmoss = ['eskimos', 'smokies']
eeiqrsu = ['esquire', 'queries']
eeeprst = ['estrepe', 'steeper']
eorsstu = ['estrous', 'oestrus', 'ousters', 'sourest', 'toruses']
cehinst = ['ethnics', 'sthenic']
aceertx = ['exacter', 'excreta']
ceiortx = ['excitor', 'xerotic']
deeilsy = ['eyelids', 'seedily']
aceefin = ['faience', 'fiancee']
acefins = ['fancies', 'fiances']
aefmrrs = ['farmers', 'framers']
aefnsst = ['fastens', 'fatness']
deefgin = ['feeding', 'feigned']
eefginr = ['feigner', 'freeing', 'reefing']
eeflnos = ['felones', 'oneself']
eefirrs = ['ferries', 'refires', 'refries']
efghirt = ['fighter', 'freight']
efilrst = ['filters', 'lifters', 'stifler', 'trifles']
definrs = ['finders', 'friends']
fgiiknn = ['finking', 'knifing']
efinsst = ['fitness', 'infests']
efhilms = ['flemish', 'himself']
eflorsw = ['flowers', 'reflows']
eflrstu = ['fluster', 'restful']
deflors = ['folders', 'refolds']
eforsst = ['forests', 'fosters']
adforrw = ['forward', 'froward']
aeflnru = ['frenula', 'funeral']
efflrtu = ['fretful', 'truffle']
befilsu = ['fusible', 'subfile']
abbeglr = ['gabbler', 'grabble']
abeglmr = ['gambler', 'gambrel']
aegnrrs = ['garners', 'rangers']
aghinrs = ['garnish', 'shangri', 'sharing']
aegnrrt = ['gartner', 'granter', 'regrant']
aaegtwy = ['gateway', 'getaway']
deggiln = ['gelding', 'niggled']
eeginnu = ['genuine', 'ingenue']
aegopst = ['gestapo', 'postage', 'potages']
degilrs = ['gilders', 'girdles', 'gliders', 'regilds']
egginrs = ['gingers', 'niggers', 'snigger']
dggiinr = ['girding', 'ridging']
agiilnt = ['gitalin', 'tailing']
degilnt = ['glinted', 'tingled']
aeglort = ['gloater', 'legator']
degloss = ['glossed', 'godless']
egilstu = ['gluiest', 'ugliest']
dggilno = ['golding', 'lodging']
adgginr = ['grading', 'niggard']
aeggnrs = ['granges', 'naggers']
aeegnrt = ['grantee', 'reagent', 'rentage', 'tangere']
aegrsty = ['grayest', 'gyrates']
eeegnrr = ['greener', 'reneger']
ffgiinr = ['griffin', 'riffing']
egoprru = ['grouper', 'regroup']
aeginnu = ['guanine', 'guinean']
eglprsu = ['gulpers', 'splurge']
egglrsu = ['gurgles', 'slugger']
adegrty = ['gyrated', 'tragedy']
acehkls = ['hackles', 'shackle']
ahllosw = ['hallows', 'shallow']
aghilnt = ['halting', 'lathing']
adehlns = ['handles', 'handsel']
aeghnrs = ['hangers', 'rehangs']
aeehnpt = ['haptene', 'phenate']
aehprrs = ['harpers', 'sharper']
adehlss = ['hassled', 'slashed']
aehrstt = ['hatters', 'shatter', 'threats']
aehrssw = ['hawsers', 'washers']
aeehrrs = ['hearers', 'rehears', 'shearer']
cehorst = ['hectors', 'torches']
eeehlrs = ['heelers', 'reheels']
acehpst = ['hepcats', 'patches']
aehilnr = ['hernial', 'inhaler']
ghiintt = ['hitting', 'tithing']
adhiloy = ['holiday', 'hyaloid', 'hyoidal']
ehlorst = ['holster', 'hostler']
ehopprs = ['hoppers', 'shopper']
ehnorst = ['hornets', 'shorten', 'thrones']
eehorvw = ['however', 'whoever']
dhimoru = ['humidor', 'rhodium']
ghinrtu = ['hurting', 'unright']
ehlsstu = ['hustles', 'sleuths']
acceips = ['icecaps', 'ipecacs']
eginors = ['ignores', 'regions', 'signore']
adeilmp = ['impaled', 'implead']
aeilmnp = ['impanel', 'maniple']
imoprst = ['imports', 'tropism']
eimprss = ['impress', 'premiss', 'simpers']
ceinsst = ['incests', 'insects']
cdeiins = ['incised', 'indices']
cdeinsu = ['incudes', 'induces']
defiiln = ['infidel', 'infield']
afginrt = ['ingraft', 'rafting']
eginrss = ['ingress', 'resigns', 'signers', 'singers']
giiklnn = ['inkling', 'linking']
adinors = ['inroads', 'ordains', 'sadiron']
eilnoss = ['insoles', 'lesions', 'lioness']
einpsst = ['insteps', 'spinets']
ailnrsu = ['insular', 'urinals']
eeginrt = ['integer', 'treeing']
einnost = ['intones', 'stenion', 'tension']
iinottu = ['intuito', 'tuition']
eeinrsv = ['inverse', 'veneris', 'venires']
eiinrtv = ['inviter', 'vitrine']
eikmors = ['irksome', 'smokier']
iprrstu = ['irrupts', 'stirrup']
eioprst = ['isopter', 'periost', 'reposit', 'riposte']
eijnors = ['joiners', 'rejoins']
eegiknn = ['keening', 'kneeing']
ceiklst = ['keltics', 'tickles']
aceikrt = ['keratic', 'tackier']
hiiknps = ['kinship', 'pinkish']
cehiknt = ['kitchen', 'thicken']
abeellr = ['labeler', 'relabel']
acelost = ['lactose', 'locates', 'scatole']
aeiklst = ['lakiest', 'talkies']
aelmnst = ['laments', 'mantels', 'mantles']
aaillmn = ['laminal', 'manilla']
aelpprs = ['lappers', 'slapper']
aaclrss = ['lascars', 'rascals', 'scalars']
aelorss = ['lassoer', 'serosal']
aeilnrt = ['latrine', 'ratline', 'reliant', 'retinal']
aailntv = ['latvian', 'valiant']
aelorvy = ['layover', 'overlay']
aegikln = ['leaking', 'linkage']
aegilnp = ['leaping', 'pealing']
aegilns = ['leasing', 'linages', 'sealing']
eegilnr = ['leering', 'reeling']
deelnrs = ['lenders', 'slender']
adelopr = ['leopard', 'paroled']
eelrstt = ['letters', 'settler', 'trestle']
deeelrv = ['levered', 'reveled']
ceeilns = ['license', 'selenic', 'silence']
eghilrt = ['lighter', 'relight']
eilnpsu = ['lineups', 'lupines', 'unpiles']
eiilnrt = ['lintier', 'nitrile']
iilopss = ['liposis', 'pilosis']
eilrsst = ['listers', 'relists']
aeillrt = ['literal', 'tallier']
adelors = ['loaders', 'ordeals', 'reloads']
ahlloty = ['loathly', 'tallyho']
abeillo = ['lobelia', 'obelial']
kloootu = ['lookout', 'outlook']
gilnoos = ['loosing', 'soloing']
gilnoot = ['looting', 'tooling']
elosstu = ['lotuses', 'solutes', 'tousles']
elorsuv = ['louvers', 'velours']
eilmpru = ['lumpier', 'plumier']
aachimn = ['machina', 'mahican']
aegmnot = ['magneto', 'megaton', 'montage']
aeilmrs = ['mailers', 'realism', 'remails']
aaelmst = ['maltase', 'tamales']
aeilmnr = ['manlier', 'mineral']
ademnru = ['manured', 'maunder', 'unarmed']
aempprs = ['mappers', 'pampers']
abdelmr = ['marbled', 'rambled']
aeimnrs = ['marines', 'remains', 'seminar']
aekmrrs = ['markers', 'remarks']
aemnrst = ['martens', 'smarten']
aemrsst = ['masters', 'streams']
acehmrt = ['matcher', 'rematch']
aemrstu = ['matures', 'strumae']
aeimstz = ['maziest', 'mestiza']
eegimnt = ['meeting', 'teeming']
deemnrs = ['menders', 'remends']
emnorst = ['mentors', 'monster']
adeimst = ['mideast', 'misdate']
aegimrt = ['migrate', 'ragtime']
iimnnos = ['minions', 'nominis']
aegimnt = ['mintage', 'teaming', 'tegmina']
eimnrtu = ['minuter', 'runtime']
adeilms = ['misdeal', 'mislead']
eiilmss = ['missile', 'similes']
giimnst = ['misting', 'smiting', 'timings']
eimnstt = ['mittens', 'smitten']
delmors = ['molders', 'remolds', 'smolder']
gimnoor = ['mooring', 'rooming']
cimnoor = ['moronic', 'omicron']
ehmorst = ['mothers', 'smother', 'thermos']
eggmrsu = ['muggers', 'smugger']
ademnnu = ['mundane', 'unnamed']
gimnssu = ['musings', 'mussing']
acnorsu = ['nacrous', 'narcous']
aenpprs = ['nappers', 'snapper']
ailnsty = ['nastily', 'saintly']
aaenrtu = ['naturae', 'taurean']
aenrstu = ['natures', 'saunter']
eehinrt = ['neither', 'therein']
eeinrrv = ['nervier', 'vernier']
eginnst = ['nesting', 'tensing']
eginntt = ['netting', 'tenting']
ennorsu = ['neurons', 'nonuser']
eeinrsw = ['newsier', 'wieners']
aceintt = ['nictate', 'tetanic']
enorsst = ['nosters', 'tensors']
eehnorw = ['nowhere', 'whereon']
ailnptu = ['nuptial', 'patulin']
einorst = ['oestrin', 'orients', 'stonier']
aeffkot = ['offtake', 'takeoff']
ainoort = ['ontario', 'oration']
aenoprt = ['operant', 'pronate', 'protean', 'tropane']
acelors = ['oracles', 'solacer']
deeorrr = ['orderer', 'reorder']
giinors = ['origins', 'signori']
ginostu = ['ousting', 'outings']
ellostu = ['outsell', 'sellout']
aklotuw = ['outwalk', 'walkout']
aailorv = ['ovarial', 'variola']
aeorsvw = ['oversaw', 'reavows']
addelpr = ['paddler', 'peddlar']
aelmprs = ['palmers', 'sampler']
aceilnp = ['panicle', 'pelican']
aeinpst = ['panties', 'sapient', 'spinate']
aceiprt = ['paretic', 'picrate']
aelprsy = ['parleys', 'parsley', 'players', 'replays', 'sparely']
adioprt = ['parotid', 'partido']
aeprrss = ['parsers', 'raspers', 'sparser']
adeiprt = ['partied', 'pirated']
aginprt = ['parting', 'prating']
aeprsst = ['pasters', 'repasts', 'sparest']
aginpst = ['pasting', 'tapings']
anoprst = ['patrons', 'tarpons']
addeelp = ['pedaled', 'pleaded']
eeelprs = ['peelers', 'sleeper']
ceilnps = ['pencils', 'splenic']
einnops = ['pension', 'pinones']
aceelpr = ['percale', 'replace']
ceprssu = ['percuss', 'spruces']
efmoprr = ['perform', 'preform']
eeipqru = ['perique', 'reequip']
eopprsu = ['peropus', 'purpose']
eiprsst = ['persist', 'priests', 'spriest', 'sprites', 'stirpes', 'stripes']
eeprstt = ['pertest', 'petters', 'pretest']
eeprsst = ['pesters', 'presets']
aeoprst = ['petrosa', 'seaport']
aehprss = ['phasers', 'phrases', 'seraphs', 'shapers', 'sherpas']
ehilprt = ['philter', 'philtre']
dhiopty = ['phytoid', 'typhoid']
ceeiprs = ['pierces', 'precise', 'recipes']
ceinprs = ['pincers', 'princes']
eiopstu = ['piteous', 'poustie']
aeilnpr = ['plainer', 'praline']
aelnprs = ['planers', 'replans']
aelnprt = ['planter', 'replant']
aelprtt = ['platter', 'prattle']
eloprss = ['plessor', 'slopers']
denoprs = ['ponders', 'respond']
ciooprt = ['porotic', 'portico', 'prootic']
eoprssu = ['poruses', 'poseurs']
amnopst = ['postman', 'tampons']
eoprstt = ['potters', 'protest', 'spotter']
aeprrsy = ['prayers', 'sprayer']
aepprsy = ['prepays', 'yappers']
eeprrss = ['presser', 'repress']
eeenprt = ['preteen', 'terpene']
egnopry = ['progeny', 'pyrogen']
nooprst = ['protons', 'sporont']
ilnopsu = ['pulsion', 'upsilon']
deprsuu = ['pursued', 'usurped']
eprsttu = ['putters', 'sputter']
eeiqrtu = ['quieter', 'requite']
acekrst = ['rackets', 'restack', 'tackers']
aefrrst = ['rafters', 'strafer']
aeirrss = ['raisers', 'sierras']
aeknrst = ['rankest', 'tankers']
aerrstt = ['ratters', 'restart', 'starter']
aaegrsv = ['ravages', 'savager']
adeerrs = ['readers', 'rereads']
aelorrt = ['realtor', 'relator']
aeeprrs = ['reapers', 'spearer']
cdeersu = ['recused', 'reduces', 'rescued', 'secured', 'seducer']
deeilnr = ['redline', 'relined']
ddenoru = ['redound', 'rounded']
eefilrs = ['refiles', 'reliefs']
egnorrw = ['regrown', 'wronger']
aemorrs = ['remoras', 'roamers']
eenrrst = ['renters', 'sterner']
eeiprrs = ['reprise', 'respire']
ceerssu = ['rescues', 'secures']
deeerss = ['reseeds', 'seeders']
eeerrsv = ['reserve', 'reveres', 'reverse', 'severer']
eorrsst = ['resorts', 'rosters', 'sorters']
eellprs = ['respell', 'speller']
aemprst = ['restamp', 'stamper', 'tampers']
cekorst = ['restock', 'rockets', 'stocker']
elrsstu = ['results', 'rustles', 'ulsters']
eersstt = ['retests', 'setters', 'streets', 'tersest', 'testers']
aeeinrt = ['retinae', 'trainee']
eeirrst = ['retires', 'retries']
aeinrrt = ['retrain', 'terrain', 'trainer']
aeilrrt = ['retrial', 'trailer']
enrrstu = ['returns', 'turners']
eiirstv = ['revisit', 'visiter']
eeghirw = ['reweigh', 'weigher']
deinrsw = ['rewinds', 'winders']
ekorrsw = ['reworks', 'workers']
bbinors = ['ribbons', 'robbins']
eilmrss = ['rimless', 'smilers']
eiorrst = ['rioters', 'roister']
denorst = ['rodents', 'snorted']
eeorstt = ['rosette', 'tetrose']
ginorsu = ['rousing', 'souring']
ginortu = ['routing', 'touring']
dilorwy = ['rowdily', 'wordily']
inorsuu = ['ruinous', 'urinous']
delrstu = ['rustled', 'strudel']
aelrssv = ['salvers', 'slavers']
adeinrs = ['sandier', 'sardine']
ainossu = ['sanious', 'suasion']
aceirsu = ['saucier', 'uricase']
aegllsu = ['seagull', 'sullage']
aelnssu = ['sensual', 'unseals']
aeirrst = ['serrati', 'tarries']
eginrsv = ['serving', 'versing']
ehinrss = ['shiners', 'shrines']
ehikrss = ['shrieks', 'shrikes']
dgiilns = ['sidling', 'sliding']
ggiinns = ['signing', 'singing']
eilrssv = ['silvers', 'slivers']
agiknst = ['skating', 'staking', 'takings', 'tasking']
giilmns = ['sliming', 'smiling']
denoops = ['snooped', 'spooned']
deilors = ['soldier', 'solider']
ginorst = ['sorting', 'storing']
iiprsst = ['spirits', 'tripsis']
oprsstu = ['sprouts', 'stupors']
aeklrst = ['stalker', 'talkers']
aginstt = ['stating', 'tasting']
aginsty = ['staying', 'stygian']
aersttw = ['stewart', 'swatter']
eillrst = ['stiller', 'tillers', 'trellis']
einrstt = ['stinter', 'tinters']
deirrst = ['stirred', 'strider']
ilnosty = ['stonily', 'tylosin']
deerstw = ['strewed', 'wrested']
densttu = ['student', 'stunted']
aamrstu = ['sumatra', 'traumas']
fnoorsu = ['sunroof', 'unroofs']
aimnrsu = ['suramin', 'surinam']
allosww = ['swallow', 'wallows']
dehissw = ['swedish', 'swished']
eelrstw = ['swelter', 'welters', 'wrestle']
elossty = ['systole', 'tolseys', 'tyloses']
aennstt = ['tannest', 'tenants']
aersttt = ['tartest', 'tatters']
aeinrtu = ['taurine', 'urinate']
eeerstt = ['teeters', 'teretes']
ceiklrt = ['tickler', 'trickle']
beimrst = ['timbers', 'timbres']
deooprt = ['toedrop', 'torpedo', 'trooped']
beinrtu = ['tribune', 'turbine']
errsttu = ['truster', 'turrets']
einrstw = ['twiners', 'winters']
aceirsv = ['varices', 'viscera']
eillosv = ['villose', 'vollies']
adenrsw = ['wanders', 'wardens']
aeehrtw = ['weather', 'whereat', 'wreathe']
ehiltwy = ['whitely', 'whitley']
ehirstw = ['withers', 'writhes']
abehorrr = ['abhorrer', 'harborer']
abbeorrs = ['absorber', 'reabsorb']
acceeprt = ['accepter', 'reaccept']
aacclrsu = ['accruals', 'caraculs', 'saccular']
acciinot = ['aconitic', 'cationic', 'itaconic']
aceimnot = ['actionem', 'noematic']
aacorttu = ['actuator', 'autocrat']
adeiinst = ['adenitis', 'dainties']
adeoprst = ['adopters', 'readopts']
abddeors = ['adsorbed', 'roadbeds']
aacdimny = ['adynamic', 'cyanamid']
aacgirst = ['agastric', 'gastrica']
aaegilnt = ['agential', 'alginate']
acginost = ['agnostic', 'coasting', 'coatings']
aaeilnpr = ['airplane', 'perianal']
aailmrst = ['alarmist', 'alastrim', 'martials']
aeelrrst = ['alerters', 'alterers', 'relaters']
aeiilnst = ['alienist', 'litanies']
adellott = ['allotted', 'totalled']
aailnost = ['alstonia', 'laotians']
ailmrstu = ['altruism', 'muralist', 'ultraism']
aaceimnr = ['amacrine', 'american', 'cinerama']
abeimrtv = ['ambivert', 'verbatim']
acegimnr = ['amercing', 'creaming', 'germanic']
aadeimnt = ['aminated', 'animated']
aceimnst = ['amnestic', 'semantic']
aaenpsst = ['anapests', 'peasants']
aceinnst = ['ancients', 'canniest', 'instance']
aemnrstu = ['anestrum', 'menstrua']
aeimnrsu = ['aneurism', 'arsenium', 'suriname']
aegginnr = ['angering', 'enraging']
aeginrst = ['angriest', 'astringe', 'gantries', 'granites', 'ingrates', 'rangiest']
aeeinstt = ['anisette', 'tetanies']
aceinort = ['anoretic', 'creation', 'reaction']
aeginnst = ['antigens', 'gentians']
aacilpst = ['aplastic', 'capitals']
aaeelppr = ['appealer', 'reappeal']
aachimrs = ['archaism', 'charisma']
aegmnrtu = ['argentum', 'argument']
adeinrss = ['aridness', 'sardines']
adeerrst = ['arrested', 'retreads', 'serrated']
aagnorrt = ['arrogant', 'tarragon']
aimnorsu = ['arsonium', 'urinomas']
aceilrst = ['articles', 'recitals']
aainrsst = ['artisans', 'tsarinas']
abcdeirs = ['ascribed', 'carbides']
adeeprss = ['aspersed', 'repassed']
acehiprs = ['aspheric', 'seraphic']
aaeiprst = ['aspirate', 'parasite']
aaginssy = ['assaying', 'gainsays']
aeenrsst = ['assenter', 'rateness']
aeerrsst = ['asserter', 'reassert']
aeginrss = ['assigner', 'reassign']
aaegsssu = ['assuages', 'sausages']
aeimrsst = ['asterism', 'smarties']
aehisstt = ['atheists', 'hastiest']
aciortty = ['atrocity', 'citatory']
aaeinrtt = ['attainer', 'reattain']
adeeentt = ['attendee', 'edentate']
aginnttu = ['attuning', 'taunting']
aceorstu = ['auctores', 'outraces']
aeginrtv = ['averting', 'grievant']
abbbgiln = ['babbling', 'blabbing']
aabcdkrw = ['backward', 'drawback']
aabcelnr = ['balancer', 'barnacle']
abeilmst = ['balmiest', 'timbales']
abeinort = ['baritone', 'obtainer', 'reobtain']
abdeginr = ['bearding', 'breading']
bdeeggru = ['begrudge', 'debugger']
bdeeglno = ['belonged', 'englobed']
abeginrt = ['berating', 'rebating']
beghinrt = ['berthing', 'brighten', 'bringeth']
bdegiint = ['betiding', 'debiting']
abefiort = ['biforate', 'fireboat']
abeiinrs = ['binaries', 'iberians', 'siberian']
abeklnst = ['blankest', 'blankets']
abgilnst = ['blasting', 'stabling']
begilnss = ['blessing', 'glibness']
abelorst = ['bloaters', 'storable']
bbbgilno = ['blobbing', 'bobbling']
belorstt = ['blotters', 'bottlers']
bfhilosw = ['blowfish', 'fishbowl']
begilllu = ['bluegill', 'gullible']
belrsstu = ['blusters', 'bustlers']
bdelnoss = ['boldness', 'bondless']
beelnoss = ['boneless', 'noblesse']
bdelloor = ['bordello', 'doorbell']
aabeegkr = ['brakeage', 'breakage']
abgilnrw = ['brawling', 'warbling']
abdeerst = ['breasted', 'debaters']
beikrsst = ['briskest', 'briskets']
bdeiorrs = ['broiders', 'disrober']
bdeeffru = ['buffered', 'rebuffed']
bdeeknru = ['bunkered', 'debunker']
bdeerttu = ['buttered', 'rebutted']
benorttu = ['buttoner', 'rebutton']
accgikln = ['cackling', 'clacking']
aacelrsu = ['caesural', 'saecular']
aceggiln = ['cageling', 'glaceing']
acllmosu = ['callosum', 'mollusca']
abcdeemr = ['cambered', 'embraced']
aaceinrs = ['canaries', 'cesarian', 'sarcinae']
accdinor = ['cancroid', 'draconic']
acdeenrt = ['cantered', 'crenated', 'decanter', 'recanted']
aaclprsu = ['capsular', 'scapular']
aceerrss = ['caresser', 'creasers']
aaceinrt = ['carinate', 'craniate']
acginrsv = ['carvings', 'cravings']
acckosss = ['cassocks', 'cossacks']
aceerrst = ['caterers', 'recrates', 'retraces', 'terraces']
aceilrsv = ['cavilers', 'claviers', 'visceral']
cdeenors = ['censored', 'encoders', 'seconder']
aceimrst = ['ceramist', 'matrices']
acdeeinv = ['cevadine', 'deviance']
acghikln = ['chalking', 'hackling']
acehnrst = ['chanters', 'snatcher']
acehmrrs = ['charmers', 'marchers']
acehrrst = ['charters', 'recharts']
acehrstt = ['chatters', 'ratchets']
aceghint = ['cheating', 'teaching']
acehlort = ['chelator', 'chlorate', 'trochlea']
acchinno = ['chincona', 'cinchona']
cehilort = ['chlorite', 'clothier']
aceeilnr = ['cinereal', 'reliance']
acdeilst = ['citadels', 'dialects']
aceilmrs = ['claimers', 'miracles', 'reclaims']
acggilnn = ['clanging', 'glancing']
acgilnps = ['clasping', 'scalping']
aaccilnv = ['clavacin', 'vaccinal']
aceilmst = ['clematis', 'climates']
aceilmsx = ['climaxes', 'exclaims']
ceilpprs = ['clippers', 'cripples']
ceilorst = ['cloister', 'costlier']
celrsttu = ['clutters', 'scuttler']
accinoot = ['coaction', 'octanoic']
aceorsst = ['coarsest', 'coasters', 'socrates']
cdgilnos = ['codlings', 'scolding']
ceelossu = ['coleuses', 'leucoses']
celoorrs = ['colorers', 'recolors']
ciilopst = ['colpitis', 'politics']
ceiimost = ['comities', 'semiotic']
ceilmops = ['compiles', 'complies', 'polemics']
cceinort = ['concerti', 'necrotic']
cdelnoos = ['condoles', 'consoled']
cdelnosy = ['condyles', 'secondly']
cdiimnou = ['conidium', 'mucinoid']
ceenorsv = ['conserve', 'converse']
cenorstu = ['construe', 'counters', 'recounts', 'trounces']
cnoorstu = ['contours', 'croutons']
ceenorvy = ['conveyer', 'reconvey']
ceikorst = ['corkiest', 'rockiest', 'stockier']
cemorstu = ['costumer', 'customer']
ceeiorst = ['coteries', 'esoteric']
celnossu = ['counsels', 'uncloses']
ceeorrsv = ['coverers', 'recovers']
cgilnosw = ['cowlings', 'scowling']
aceemrrs = ['creamers', 'screamer']
aceeirtv = ['creative', 'reactive']
cddeeirt = ['credited', 'directed']
ceiprstu = ['crepitus', 'pictures']
ccehorst = ['crochets', 'crotches']
acdilort = ['crotalid', 'dicrotal']
ceirrssu = ['cruisers', 'scurries']
ceirrstu = ['crustier', 'recruits']
ceelrssu = ['cureless', 'recluses']
adeenssu = ['danseuse', 'sudanese']
adeeilnt = ['dateline', 'entailed']
addgilnw = ['dawdling', 'waddling']
adegilns = ['dealings', 'leadings', 'signaled']
acddeent = ['decadent', 'decanted']
cddeeirs = ['deciders', 'descried']
acdeilms = ['decimals', 'declaims']
cdeeilnr = ['decliner', 'reclined']
cdeginoy = ['decoying', 'gynecoid']
adeflstu = ['defaults', 'sulfated']
deeefrrr = ['deferrer', 'referred']
defgiiln = ['defiling', 'fielding']
deeforst = ['deforest', 'forested', 'fostered']
defgiiny = ['deifying', 'edifying']
deeilrsv = ['delivers', 'silvered', 'slivered']
deilnosu = ['delusion', 'unsoiled']
addeemnr = ['demander', 'redemand', 'remanded']
deimnoot = ['demotion', 'motioned']
ddeemrru = ['demurred', 'murdered']
deenrstu = ['dentures', 'sederunt']
deeelpst = ['depletes', 'steepled']
addeeprv = ['depraved', 'pervaded']
addeegnr = ['deranged', 'gardened']
adeginrt = ['derating', 'gradient', 'treading']
deiinors = ['derision', 'ironside', 'resinoid']
adeelrst = ['desalter', 'treadles']
deeginrs = ['designer', 'redesign', 'resigned']
deilopss = ['despoils', 'diploses']
adeeilrt = ['detailer', 'retailed']
deeerstt = ['detester', 'retested']
adeenott = ['detonate', 'tetanode']
deenortu = ['deuteron', 'undertoe']
deeirssv = ['devisers', 'dissever']
adeilost = ['diastole', 'isolated']
deirsstu = ['diestrus', 'studiers', 'sturdies']
deilnstu = ['diluents', 'insulted', 'unlisted']
cdeinrss = ['discerns', 'rescinds']
cdeeirst = ['discreet', 'discrete']
ddeinosw = ['disowned', 'downside']
deioprss = ['disposer', 'dropsies']
deiprstu = ['disputer', 'stupider']
adeisstt = ['distaste', 'staidest']
diiinosv = ['division', 'indiviso']
deimnoos = ['dominoes', 'monodies']
doooprst = ['doorpost', 'doorstop']
bdeorstu = ['doubters', 'obtrudes', 'redoubts']
adeilotv = ['dovetail', 'violated']
dnnortuw = ['downturn', 'turndown']
adegnrst = ['dragnets', 'grandest']
deillrrs = ['drillers', 'redrills']
dggginru = ['drugging', 'grudging']
addelnou = ['duodenal', 'unloaded']
aeginnrs = ['earnings', 'grannies']
aehilrty = ['earthily', 'heartily']
deeginss = ['edginess', 'seedings']
deiinost = ['editions', 'sedition']
deilnoos = ['eidolons', 'solenoid']
aegilnps = ['elapsing', 'pleasing']
ceeeelst = ['electees', 'selectee']
eiilnoss = ['elisions', 'oiliness']
aadeemnt = ['emanated', 'mandatee']
aeeimrst = ['emirates', 'steamier']
eeimrstt = ['emitters', 'termites']
aehimpss = ['emphasis', 'misshape']
aeehmnnt = ['enanthem', 'menthane']
ceimmnou = ['encomium', 'meconium']
eeeginrs = ['energies', 'resignee']
eejnorsy = ['enjoyers', 'reenjoys']
deeilnst = ['enlisted', 'listened']
eeilnrst = ['enlister', 'listener', 'reenlist']
aeegilns = ['ensilage', 'lineages']
eeennstt = ['ententes', 'tenentes']
ceeinrst = ['enticers', 'scienter', 'secretin']
eeinrtty = ['entirety', 'eternity']
aeilnrst = ['entrails', 'latrines', 'ratlines']
aeerrssu = ['erasures', 'reassure']
bdeeilor = ['erodible', 'reboiled']
aeeimstt = ['estimate', 'meatiest']
aeeegrst = ['etageres', 'steerage']
ceiorstv = ['evictors', 'vortices']
cdeeeptx = ['excepted', 'expected']
eeoprrtx = ['exporter', 'reexport']
abefilll = ['fallible', 'fillable']
aeefnrst = ['fastener', 'fenestra', 'refasten']
eefginrs = ['feigners', 'freeings']
efginrry = ['ferrying', 'refrying']
efghirst = ['fighters', 'freights']
aacflrst = ['flatcars', 'fractals']
aeflsstu = ['flatuses', 'sulfates']
eeforrst = ['forester', 'fosterer', 'reforest']
afilmnor = ['formalin', 'informal']
ceefinrt = ['frenetic', 'infecter', 'reinfect']
adeegnrr = ['gardener', 'garnered']
adeegrrt = ['gartered', 'regrated']
aeeghrrt = ['gatherer', 'regather']
aeegilnt = ['gelatine', 'legatine']
aegilnst = ['gelatins', 'genitals', 'stealing']
deggilns = ['geldings', 'sledging']
eegilnst = ['gentiles', 'sleeting', 'steeling']
aegimnnr = ['germanin', 'renaming']
dggiilnr = ['girdling', 'ridgling']
egilmoor = ['gloomier', 'oligomer']
ggilnoss = ['glossing', 'goslings']
egmnoory = ['gonomery', 'merogony']
aadgmnrs = ['grandams', 'grandmas']
eegginnr = ['greening', 'reneging']
egilmnrs = ['gremlins', 'minglers']
degnorru = ['grounder', 'reground']
eggilnru = ['grueling', 'regluing']
degilrsu = ['guilders', 'sludgier']
ghnosstu = ['gunshots', 'shotguns']
adeehlrt = ['haltered', 'lathered']
adhnostu = ['handouts', 'thousand']
aeghnorv = ['hangover', 'overhang']
abghprsu = ['hapsburg', 'subgraph']
ahiprsst = ['harpists', 'starship']
aghilnss = ['hassling', 'lashings', 'slashing']
aghinsst = ['hastings', 'stashing']
aehnrstu = ['haunters', 'unearths']
adeghins = ['headings', 'sheading']
eehilrss = ['heirless', 'relishes']
aeghnopt = ['heptagon', 'pathogen']
cdhiiort = ['hidrotic', 'trichoid']
chiiorst = ['historic', 'orchitis']
ehlorsst = ['holsters', 'hostlers']
aehmnors = ['horseman', 'menorahs', 'rhamnose']
ahmnnstu = ['huntsman', 'manhunts']
ghilnstu = ['hustling', 'sunlight']
adeiinot = ['ideation', 'iodinate']
deeimmrs = ['immersed', 'simmered']
aeilmprs = ['impalers', 'impearls', 'lempiras']
deeimprs = ['impeders', 'premised', 'simpered']
eimoprss = ['imposers', 'promises', 'semipros']
ceeinnss = ['incenses', 'niceness']
ddeeinnt = ['indented', 'intended']
cdeiinrt = ['indicter', 'indirect', 'reindict']
aeiinrst = ['inertias', 'rainiest']
efimnorr = ['informer', 'reinform', 'reniform']
eeginnsu = ['ingenues', 'unseeing']
ghinortw = ['ingrowth', 'throwing']
aeinnotv = ['innovate', 'venation']
deeinrst = ['inserted', 'resident', 'sentried']
deiinsst = ['insisted', 'tidiness']
adeinstt = ['instated', 'testandi']
iinorstt = ['institor', 'introits']
eeginrst = ['integers', 'steering']
eeeinnrt = ['internee', 'retinene']
deeinrrt = ['interred', 'trendier']
eeinrssv = ['inverses', 'serviens']
giinnors = ['ironings', 'nigrosin', 'rosining']
abeilssu = ['issuable', 'suasible']
aeeirstt = ['iterates', 'teariest', 'treaties', 'treatise']
eeknosty = ['keynotes', 'keystone']
egiiklnr = ['kinglier', 'ringlike']
eiknrstt = ['knitters', 'trinkets']
aabdlorr = ['labrador', 'larboard']
aacelntu = ['lacunate', 'tenacula']
aeelmnss = ['lameness', 'maleness', 'nameless', 'salesmen']
aehilrsv = ['lavisher', 'shrieval']
aelorsvy = ['layovers', 'overlays']
aabeells = ['leasable', 'saleable', 'sealable']
aegillst = ['legalist', 'stillage']
deeelnss = ['lessened', 'needless']
aelorstv = ['levators', 'oversalt']
abeeillv = ['leviable', 'liveable']
ceeilnrs = ['licenser', 'reclines', 'silencer']
cgiiklns = ['lickings', 'sickling', 'slicking']
aeillrst = ['literals', 'talliers']
aillortt = ['littoral', 'tortilla']
eeilnssv = ['liveness', 'vileness']
eilnoost = ['looniest', 'oilstone']
eilmpstu = ['lumpiest', 'plumiest']
aaceemrt = ['macerate', 'racemate']
aegmnost = ['magnetos', 'megatons', 'montages']
aacelmns = ['manacles', 'scaleman']
aegmnorv = ['mangrove', 'venogram']
abgilmnr = ['marbling', 'rambling']
adeemrst = ['mastered', 'streamed']
aemrsstt = ['mattress', 'smartest']
adeemrsu = ['measured', 'uredemas']
aceemnot = ['meconate', 'metacone']
deillmnu = ['medullin', 'unmilled']
aeelmnst = ['mentales', 'talesmen']
eeimrrst = ['merriest', 'triremes']
eegimnrt = ['metering', 'regiment']
agimnrst = ['migrants', 'smarting']
eimnrsst = ['minsters', 'trimness']
adeilmss = ['misdeals', 'misleads']
eilmpsst = ['misspelt', 'simplest']
aeimrstt = ['mistreat', 'teratism']
ailmorty = ['molarity', 'morality']
imnoorty = ['monitory', 'moronity']
deimoost = ['moodiest', 'sodomite']
emnorstu = ['mounters', 'remounts']
aeilmttu = ['mutilate', 'ultimate']
aiimnstv = ['nativism', 'vitamins']
aelmnops = ['neoplasm', 'plasmone', 'pleonasm']
eimnopst = ['nepotism', 'pimentos']
aellnruy = ['neurally', 'unreally']
acghinpt = ['nightcap', 'patching']
aeinrstt = ['nitrates', 'straiten']
cehnnosu = ['nonesuch', 'unchosen']
cdeilnou = ['nucleoid', 'uncoiled']
abcorssu = ['obscuras', 'scabrous']
adeelnor = ['oleander', 'reloaned']
ainooptt = ['optation', 'potation']
aginorst = ['organist', 'roasting']
ehoorsst = ['orthoses', 'shooters', 'soothers']
hooosttu = ['outshoot', 'shootout']
aklostuw = ['outwalks', 'walkouts']
aceorstv = ['overacts', 'overcast']
deeoorsv = ['overdoes', 'overdose']
aeekortv = ['overtake', 'takeover']
enorrtuv = ['overturn', 'turnover']
aeinprst = ['painters', 'pantries', 'parentis', 'pertains', 'repaints']
aeilprrt = ['paltrier', 'pretrial']
aceilnps = ['panicles', 'pelicans']
acdeelpr = ['parceled', 'replaced']
aehiprss = ['parishes', 'sharpies']
adeoprrt = ['parroted', 'predator', 'prorated', 'teardrop']
aelprssy = ['parsleys', 'sparsely']
aaloprst = ['pastoral', 'proatlas']
aeprrstu = ['pasturer', 'raptures']
aeeprrtt = ['patterer', 'pretreat']
adegilnp = ['pedaling', 'pleading']
cdeiilpu = ['pediculi', 'pulicide']
eeelprss = ['peerless', 'sleepers']
ceepprst = ['percepts', 'precepts']
efmoprrs = ['performs', 'preforms']
eeprrssu = ['perusers', 'pressure']
eioprsuv = ['pervious', 'previous', 'viperous']
aeinpstu = ['petunias', 'supinate']
aghinprs = ['phrasing', 'sharping']
giinnnps = ['pinnings', 'spinning']
aelprsst = ['plasters', 'psalters', 'staplers']
adeelprs = ['pleaders', 'relapsed']
einoprst = ['pointers', 'proteins']
einooprs = ['poisoner', 'snoopier']
inooprst = ['portions', 'positron', 'sorption']
ginopsst = ['postings', 'signpost']
deoprstu = ['postured', 'proudest', 'sprouted']
aeoprrst = ['praetors', 'prorates']
deelprsu = ['preludes', 'repulsed']
eimmprsu = ['premiums', 'spermium']
eeiprrtt = ['preterit', 'prettier']
cdeoprru = ['procured', 'producer']
eioprsst = ['prosiest', 'ripostes']
aelnprsu = ['purslane', 'supernal']
ginprsuu = ['pursuing', 'usurping']
aeilqrtu = ['quartile', 'requital']
adeeiprr = ['rapiered', 'repaired']
adeeirst = ['readiest', 'steadier']
aeeilrsz = ['realizes', 'sleazier']
bdenorsu = ['rebounds', 'suborned']
cdeeerss = ['recessed', 'seceders']
ceeorrsu = ['recourse', 'resource']
cdeerrsu = ['recursed', 'reducers']
ceginrsu = ['recusing', 'rescuing', 'securing']
ddeefnru = ['refunded', 'underfed']
adeeelrs = ['released', 'resealed']
egiilnrv = ['reliving', 'reviling']
aeeeprrt = ['repartee', 'repeater']
eginoprs = ['reposing', 'spongier']
eeiprrss = ['reprises', 'respires']
deeerrsv = ['reserved', 'reversed']
eeerrssv = ['reserves', 'reverses']
deeorrst = ['resorted', 'restored']
ceeprsst = ['respects', 'scepters', 'specters']
aeffrsst = ['restaffs', 'staffers']
aerrsstt = ['restarts', 'starters']
aeinrrst = ['restrain', 'retrains', 'strainer', 'terrains', 'trainers', 'transire']
emmnorsu = ['resummon', 'summoner']
ehiknrst = ['rethinks', 'thinkers']
deeinrtu = ['retinued', 'reunited']
aeerrstt = ['retreats', 'treaters']
aeilrrst = ['retrials', 'trailers']
eeilrrsv = ['revilers', 'silverer']
egilnrst = ['ringlets', 'sterling', 'tinglers']
deiiprst = ['riptides', 'spirited']
denorstu = ['roundest', 'unsorted']
deiorstw = ['rowdiest', 'wordiest']
eirssttu = ['rustiest', 'trusties']
aeiinsst = ['sanities', 'teniasis']
aceisstu = ['sauciest', 'suitcase']
adeeessw = ['seaweeds', 'seesawed']
eginsstt = ['settings', 'testings']
ghinoost = ['shooting', 'soothing']
abeiilst = ['sibilate', 'tibiales']
dehinops = ['siphoned', 'sphenoid']
aceilpss = ['slipcase', 'specials']
acdehnst = ['snatched', 'stanched']
eioprstv = ['sorptive', 'sportive']
aeprssst = ['sparsest', 'trespass']
eiprsstt = ['spitters', 'tipsters']
aekosttu = ['stakeout', 'takeouts']
aeirrrst = ['starrier', 'tarriers']
eeelrsst = ['steelers', 'treeless']
aginrsty = ['stingray', 'straying']
eginrstw = ['strewing', 'wresting']
deinrstt = ['strident', 'tridents']
ellorrst = ['stroller', 'trollers']
emprsttu = ['strumpet', 'trumpets']
aghinssw = ['swashing', 'washings']
eelrsstw = ['swelters', 'wrestles']
acinrttu = ['taciturn', 'urticant']
amnrsttu = ['tantrums', 'trustman']
acchiort = ['thoracic', 'trochaic']
eimosttu = ['timeouts', 'titmouse']
abilnrtu = ['tribunal', 'turbinal']
aeginrtw = ['twangier', 'watering']
acdenrtu = ['uncrated', 'underact', 'untraced']
adeenrsu = ['undersea', 'unerased']
adeelnsu = ['unleased', 'unsealed']
deenrsuv = ['unserved', 'unversed']
aaceilnv = ['valencia', 'valiance']
aeglnrsw = ['wanglers', 'wrangles']
eggilrsw = ['wigglers', 'wriggles']
aabdennor = ['abandoner', 'reabandon']
abilnostu = ['ablutions', 'sublation']
abhilnost = ['absinthol', 'biathlons']
aabdeinst = ['abstained', 'bastinade']
accdeinst = ['accidents', 'desiccant']
acceorstu = ['accouters', 'coruscate']
aacdeeimt = ['acetamide', 'emaciated']
aaceloprt = ['acropetal', 'cleopatra']
aacorsttu = ['actuators', 'autocrats']
adejrsstu = ['adjusters', 'readjusts']
adeiimssv = ['admissive', 'misadvise']
aadilnotu = ['adulation', 'laudation']
adelnsstu = ['adultness', 'dauntless']
aeeemorrt = ['aerometer', 'areometer']
aeeginrst = ['agentries', 'reseating']
aeelnrsst = ['alertness', 'sternales']
aceeiklmu = ['aleukemic', 'leukaemic']
aaegilnrs = ['algerians', 'glaserian']
aghilmort = ['algorithm', 'logarithm']
aegilmnnt = ['alignment', 'lamenting']
aeeilmnnt = ['alinement', 'lineament']
acegillno = ['allogenic', 'collegian']
aellorstt = ['allotters', 'totallers']
acillopty = ['allotypic', 'optically', 'topically']
aeilnnost = ['alstonine', 'tensional']
adeilsttu = ['altitudes', 'latitudes']
aagiimnnt = ['aminating', 'animating']
aeeimnsst = ['amnesties', 'meatiness']
aeimorstz = ['amortizes', 'atomizers']
ailmnopsy = ['amylopsin', 'olympians']
aacegilns = ['analgesic', 'angelicas']
aacimnost = ['anatocism', 'anosmatic']
aacillnry = ['ancillary', 'cranially']
aenorsstu = ['anestrous', 'anoestrus']
aagnorstu = ['angostura', 'argonauts']
acdiinort = ['anidrotic', 'indicator']
aeiinnstu = ['annuities', 'insinuate']
achimnors = ['anorchism', 'harmonics']
aaeilnpst = ['antilapse', 'palatines']
aeinoprtt = ['antitrope', 'tritanope']
aaegilnpp = ['appealing', 'lagniappe']
aeinopprt = ['appointer', 'reappoint']
aadeipprs = ['appraised', 'disappear']
aeeginnrt = ['argentine', 'tangerine']
aegnorstu = ['argentous', 'outranges']
aeiirrstt = ['arteritis', 'irritates']
aaceinrst = ['ascertain', 'cartesian', 'sectarian']
aainprsst = ['aspirants', 'partisans']
aaeiprsst = ['aspirates', 'parasites', 'satrapies']
aeorrssst = ['assertors', 'reassorts']
aeginrsss = ['assigners', 'reassigns']
aaagilrst = ['astragali', 'tarsalgia']
aaeginrsy = ['asynergia', 'gainsayer']
aeehisstt = ['athetesis', 'hesitates']
aaeinrstt = ['attainers', 'reattains', 'tearstain']
aeeintttv = ['attentive', 'tentative']
aiinorttt = ['attrition', 'titration']
aacelotuv = ['autoclave', 'vacuolate']
aabceilrt = ['bacterial', 'calibrate']
aabeilnst = ['balanites', 'stainable']
aabdeginr = ['bargained', 'gabardine']
abdeelrss = ['beardless', 'breadless']
bdeeggrsu = ['begrudges', 'debuggers']
bceiijnot = ['bijection', 'objicient']
aabelmsst = ['blastemas', 'lambastes']
abcekooss = ['bookcases', 'casebooks']
aabcehirt = ['brachiate', 'chabertia']
abeeirrss = ['brasserie', 'brassiere']
abdeenorr = ['broadener', 'rebroaden']
abcellrsu = ['brucellas', 'subcellar']
beffginru = ['buffering', 'rebuffing']
beginrttu = ['buttering', 'rebutting']
acillosty = ['callosity', 'stoically']
abcegimnr = ['cambering', 'embracing']
aacceenrt = ['cancerate', 'reactance']
aceinosst = ['canoeists', 'cessation']
acginnopy = ['canopying', 'poignancy']
acgillnor = ['carolling', 'collaring']
aceelorss = ['casserole', 'escaroles']
aaceglotu = ['catalogue', 'coagulate']
accehistt = ['catchiest', 'catechist']
aceinsstt = ['cattiness', 'scantiest', 'tacitness']
aaceilrsv = ['cavaliers', 'cavalries']
abceeelrt = ['celebrate', 'erectable']
ceeemnrst = ['cementers', 'cerements']
acegimnrt = ['centigram', 'cremating']
ceeinrstu = ['centuries', 'entericus']
cdeefiirt = ['certified', 'rectified']
ceefiirst = ['certifies', 'rectifies']
aceilmnru = ['ceruminal', 'melanuric', 'numerical']
aceehrrrt = ['charterer', 'recharter']
ccdeeehkr = ['checkered', 'rechecked']
cehloorss = ['chloroses', 'schoolers']
cdeinorsu = ['cinderous', 'coinsured']
aceelnrss = ['cleansers', 'clearness']
ceilmpstu = ['clumpiest', 'multiceps']
aceilnost = ['coastline', 'sectional']
acginnoot = ['cognation', 'contagion']
ceffiorsu = ['coiffeurs', 'coiffures']
ccelmooty = ['colectomy', 'cyclotome']
acellopss = ['collapses', 'escallops']
aceillnor = ['collinear', 'coralline']
acilmnopt = ['complaint', 'compliant']
ceefnorrs = ['confreres', 'enforcers']
cceennort = ['connecter', 'reconnect']
ceennorst = ['consenter', 'nonsecret']
ceenorssv = ['conserves', 'converses']
acinoorst = ['consortia', 'sonicator']
cenorrstu = ['construer', 'trouncers']
ceenorstt = ['contester', 'recontest']
cdeinnotu = ['continued', 'unnoticed']
ceenorsvy = ['conveyers', 'reconveys']
cemorsstu = ['costumers', 'customers']
ceinorstu = ['countries', 'cretinous', 'neurotics']
ceiloprsv = ['coverslip', 'slipcover']
cdegiinrt = ['crediting', 'directing']
cdeiinort = ['cretinoid', 'direction']
cdeiirstu = ['crudities', 'diuretics']
cemoostty = ['cystotome', 'ostectomy']
acdeeilrt = ['decaliter', 'derelicta']
acddeeimt = ['decimated', 'medicated']
acdeeilmr = ['declaimer', 'reclaimed']
deeefmnrt = ['deferment', 'fermented']
deeeilrrv = ['deliverer', 'redeliver']
addegimnn = ['demanding', 'maddening']
deemrrrsu = ['demurrers', 'murderers']
adeenrstu = ['denatures', 'sauntered']
abdeelnot = ['denotable', 'detonable']
deeiinsst = ['densities', 'destinies']
adeginprt = ['departing', 'predating']
deiooprst = ['depositor', 'droopiest']
adegiilnr = ['derailing', 'grindelia']
deeeprrss = ['derepress', 'repressed']
deehnorst = ['dethrones', 'shortened']
deeeloprv = ['developer', 'redevelop']
acdeiimrt = ['diametric', 'matricide']
adeiimott = ['diatomite', 'meditatio']
deiorsstu = ['diestrous', 'dioestrus', 'outsiders']
defgiiins = ['dignifies', 'signified']
bddeinrsu = ['disburden', 'underbids']
cdeeinrrs = ['discerner', 'rescinder']
deeiimprs = ['dispireme', 'epidermis']
deeinrsst = ['dissenter', 'residents', 'tiredness']
deiillrst = ['distiller', 'redistill']
deeirstuv = ['divesture', 'servitude']
addlnoosw = ['downloads', 'woodlands']
adeehrstw = ['drawsheet', 'watershed']
aeehirstt = ['earthiest', 'heartiest', 'hesitater']
aehmorrtw = ['earthworm', 'heartworm']
ceeilnost = ['elections', 'selection']
aeelorstv = ['elevators', 'levatores']
eelmoprsy = ['employers', 'reemploys']
aeegilmnn = ['enameling', 'meningeal']
adeeginnr = ['endearing', 'engrained', 'grenadine']
adeeglnnr = ['englander', 'greenland']
egiilnnst = ['enlisting', 'listening']
aceginnor = ['enorganic', 'ignorance']
adeeilmpr = ['epidermal', 'impearled', 'impleader']
aeeinprst = ['episterna', 'praesenti', 'sparteine']
cegimnoor = ['ergonomic', 'merogonic']
aceeinrrs = ['errancies', 'increaser']
ceiooprst = ['esotropic', 'porticoes']
eeoprsssu = ['espousers', 'urosepses']
adeeimstt = ['estimated', 'meditates']
aeinnosst = ['estonians', 'sensation']
aeegnrsst = ['estranges', 'greatness', 'sergeants']
aceilpstu = ['euplastic', 'spiculate']
aeeioprtv = ['evaporite', 'operative']
ceeginptx = ['excepting', 'expecting']
eeoprrstx = ['exporters', 'reexports']
aefhilsst = ['faithless', 'flashiest']
aefhinors = ['fashioner', 'refashion']
aeeefhrrt = ['featherer', 'hereafter']
eeefinrrs = ['ferneries', 'serrefine']
efghiilrt = ['firelight', 'flightier']
aabcfhkls = ['flashback', 'halfbacks']
eefhillrs = ['fleshlier', 'shellfire']
acflnttuu = ['fluctuant', 'untactful']
eeforrsst = ['foresters', 'reforests']
efhiorstt = ['fortieths', 'frothiest']
efhinrrsu = ['furnisher', 'refurnish']
aeeghrrst = ['gatherers', 'regathers']
aeeegnrst = ['generates', 'teenagers']
aegimnrsu = ['geraniums', 'measuring']
aeegginrr = ['gregarine', 'regearing']
agmmnoors = ['groomsman', 'monograms']
aginorsty = ['gyrations', 'signatory']
aeghnorsv = ['hangovers', 'overhangs']
adeehnrrs = ['hardeners', 'rehardens']
eeehorsst = ['heteroses', 'shoetrees']
abeehinrt = ['hibernate', 'inbreathe']
adeehnors = ['hoarsened', 'rhodanese']
eehlorsss = ['horseless', 'shoreless']
eehoorsvw = ['howsoever', 'whosoever']
dhiilopsy = ['hypsiloid', 'syphiloid']
aciimnopt = ['impaction', 'ptomainic']
eimoprrst = ['importers', 'misreport']
eeimprsss = ['impresses', 'premisses']
aciinnost = ['inactions', 'onanistic']
ceilnorsu = ['inclosure', 'reclusion']
ceefinrst = ['infecters', 'reinfects']
eefiilnrt = ['infertile', 'interfile']
eeinrrsst = ['inserters', 'reinserts']
aeinnrstt = ['instanter', 'transient']
aegilnrst = ['integrals', 'triangles']
eeilnoprt = ['interlope', 'repletion', 'terpineol']
aeinosttt = ['intestato', 'testation']
aceiinrtt = ['intricate', 'triacetin']
cdeinortu = ['introduce', 'reduction']
eegiilnrv = ['inveigler', 'relieving']
aeiilnotv = ['inviolate', 'leviation']
adeeinrrt = ['irredenta', 'retrained']
aceinsssu = ['issuances', 'sauciness']
aeghlrstu = ['laughters', 'slaughter']
aegilnrwy = ['lawyering', 'wearingly']
deiilopss = ['lepidosis', 'lipidoses']
eegilnrtt = ['lettering', 'reletting']
gghiilnst = ['lightings', 'slighting']
eeilnosss = ['lionesses', 'noiseless', 'selenosis']
egiilnrtt = ['littering', 'retitling']
aceilrtuv = ['lucrative', 'revictual', 'victualer']
aceimnrsu = ['manicures', 'muscarine']
aemmnorty = ['manometry', 'momentary']
aaillmrty = ['maritally', 'martially']
ammoostty = ['mastotomy', 'stomatomy']
accehimns = ['mechanics', 'mischance']
ceilmopry = ['micropyle', 'polymeric']
aeegillms = ['misallege', 'semilegal']
degilmnor = ['moldering', 'remolding']
eemnoorst = ['monoester', 'sonometer']
emnnooost = ['monotones', 'moonstone']
egilmoosy = ['myologies', 'semiology']
almopstyy = ['myoplasty', 'polymasty']
aadegintv = ['navigated', 'vaginated']
aeghinrtw = ['nightwear', 'wreathing']
aeenopprt = ['notepaper', 'trepopnea']
benorsttu = ['obstruent', 'rebuttons']
aeginoprt = ['operating', 'pignorate']
eoopprrss = ['oppressor', 'proposers']
ehmoooprs = ['osmophore', 'sophomore']
aeginorvw = ['overawing', 'reavowing']
aeekorstv = ['overtakes', 'takeovers']
ehinoprsw = ['ownership', 'shipowner']
aadeeprst = ['paederast', 'separated']
acegilnpr = ['parceling', 'replacing']
aciioprtt = ['parotitic', 'patriotic']
aeprrsstu = ['pasturers', 'superstar']
acdeiiprt = ['patricide', 'pediatric']
aenoprsst = ['patroness', 'postnares', 'transpose']
aceelpstu = ['peculates', 'speculate']
ceoprrssu = ['percussor', 'procuress']
aelloprry = ['perorally', 'preorally']
adeeinprt = ['pertained', 'repainted']
cehinopst = ['phonetics', 'sphenotic']
ailnopstu = ['platinous', 'pulsation']
deenoprrs = ['ponderers', 'responder']
adeoprrty = ['portrayed', 'predatory']
ceeinopst = ['potencies', 'stenopeic']
adeoprrst = ['predators', 'teardrops']
ceeinprst = ['prescient', 'reinspect']
deeenprst = ['presented', 'pretensed']
aeeilprrv = ['prevailer', 'reprieval']
eoopprsst = ['proptoses', 'psoroptes']
eeprrsttu = ['putterers', 'sputterer']
aeilqrstu = ['quartiles', 'requitals']
agilnprsy = ['raspingly', 'sparingly']
cdeeorrrs = ['recorders', 'rerecords']
aceginrrt = ['recrating', 'retracing', 'terracing']
adeginrrw = ['redrawing', 'rewarding']
deegiinrt = ['reediting', 'reignited']
deggiilnr = ['regilding', 'ridgeling']
adeenrrtu = ['renatured', 'underrate']
eeginrrsv = ['reserving', 'reversing']
aeehnprrs = ['resharpen', 'sharpener']
eeorrrsst = ['resorters', 'restorers']
aeinrrsst = ['restrains', 'strainers', 'tarriness']
emmnorssu = ['resummons', 'summoners']
eiiinrstt = ['retinitis', 'trinities']
deinorssw = ['rowdiness', 'wordiness']
aadeilstv = ['salivated', 'validates']
aeelprstt = ['saltpeter', 'saltpetre']
aceinorss = ['sarcosine', 'scenarios']
ceelorsss = ['scleroses', 'scoreless']
aeehorsss = ['seahorses', 'seashores']
abeimnrsu = ['semiurban', 'submarine']
ceeeinnst = ['sentience', 'tenencies']
aehimpsst = ['shipmates', 'steamship']
aegilnsst = ['slangiest', 'tasseling']
adeemnrst = ['smartened', 'tradesmen']
acghinnst = ['snatching', 'stanching']
aeimnprst = ['spearmint', 'spermatin']
ghilopstt = ['spotlight', 'stoplight']
aeelssstt = ['stateless', 'tasteless']
adeeisstt = ['stateside', 'steadiest']
abiilstuy = ['suability', 'usability']
deginnrsu = ['sundering', 'undersign']
adeehllsw = ['swellhead', 'wellheads']
eeghinrtt = ['tethering', 'tightener']
ailnoorst = ['tonsorial', 'torsional']
abeinrttu = ['tribunate', 'turbinate']
deflnoruw = ['underflow', 'wonderful']
deeimnrtu = ['undertime', 'unmerited']
acinoostv = ['vasotocin', 'vasotonic', 'vocations']
aabdennors = ['abandoners', 'reabandons']
abinooprst = ['absorption', 'probations']
aachimnort = ['achromatin', 'machinator']
aacgiinttv = ['activating', 'cavitating']
aaadeimnnt = ['adamantine', 'amantadine']
adiimnnoot = ['admonition', 'domination']
aagillmnry = ['alarmingly', 'marginally']
aadelmnrry = ['aldermanry', 'marylander']
aegilmnnst = ['alignments', 'signalment']
acillnootu = ['allocution', 'loculation']
acehimoprt = ['amphoteric', 'metaphoric']
acehinorst = ['anchorites', 'antechoirs']
aenoorsstu = ['anoestrous', 'outreasons', 'treasonous']
aaiilmnnot = ['antimonial', 'lamination']
aeiinpssst = ['antisepsis', 'inspissate']
aahiloppsy = ['apophysial', 'hypoplasia']
ainoopprst = ['appointors', 'apportions']
acdefhinrs = ['archfiends', 'franchised']
aaceinrsst = ['ascertains', 'sectarians']
agiilnprsy = ['aspiringly', 'praisingly']
adeeimnrtt = ['attermined', 'terminated']
aabeiilnst = ['banalities', 'insatiable']
beeillrstt = ['belittlers', 'belletrist']
abdelmorst = ['blastoderm', 'dermoblast']
befllosttu = ['bottlefuls', 'bottlesful']
abdeenorrs = ['broadeners', 'rebroadens']
abelnrsstu = ['brutalness', 'subalterns', 'substernal']
acceilnoss = ['calcinoses', 'neoclassic']
acdeinoort = ['carotenoid', 'coordinate', 'decoration']
aacdeglotu = ['catalogued', 'coagulated']
accehimsst = ['catechisms', 'schematics']
acdeeilnns = ['celandines', 'decennials']
ceinoorssu = ['censorious', 'coenurosis']
ceefiirrst = ['certifiers', 'rectifiers']
aceehrrrst = ['charterers', 'recharters']
cceeghiknr = ['checkering', 'rechecking']
ccehmoorty = ['chromocyte', 'cytochrome', 'orchectomy']
acdelmnotu = ['columnated', 'documental']
ceimmnoort = ['commorient', 'metronomic']
cdemnoopru = ['compounder', 'recompound']
cceginnort = ['concerting', 'concreting']
cceeginnor = ['congeneric', 'necrogenic']
ceenoqrrsu = ['conquerers', 'reconquers']
aceinnorst = ['containers', 'sanctioner']
ceenorsstt = ['contesters', 'recontests']
ceenorrstv = ['converters', 'reconverts']
aceeiinnrt = ['creatinine', 'incinerate']
aceiirttvy = ['creativity', 'reactivity']
aaceimorrt = ['crematoria', 'mercatoria']
accghiopty = ['cytophagic', 'phagocytic']
acdegiimnt = ['decimating', 'medicating']
cdeemooprs = ['decomposer', 'recomposed']
adefilnost = ['deflations', 'defoliants']
deeeilrrsv = ['deliverers', 'redelivers']
adeinnoott = ['denotation', 'detonation']
deeeimnrst = ['densimeter', 'determines']
acdeeoprrt = ['deprecator', 'procreated']
cdeioprrst = ['descriptor', 'predictors']
deeeloprsv = ['developers', 'redevelops']
deeiimnnrt = ['dinnertime', 'intermedin']
cdeiinorst = ['directions', 'discretion']
cdeinorstu = ['discounter', 'introduces', 'rediscount', 'reductions']
cdeeilrsty = ['discreetly', 'discretely']
deiinnosst = ['dissention', 'distension']
deiinrsstu = ['disuniters', 'industries']
aeehinrsst = ['earthiness', 'heartiness']
aeghilnrst = ['earthlings', 'slathering']
cceeginort = ['egocentric', 'geocentric']
ceeinoprss = ['encopresis', 'necropsies', 'precession']
degilnnruy = ['enduringly', 'underlying']
aeeinnortv = ['enervation', 'veneration']
eeeiinrstt = ['entireties', 'eternities']
abceiilpst = ['epiblastic', 'plebiscita']
aaceiilnpr = ['epicranial', 'periacinal']
aeiimnostt = ['estimation', 'testimonia']
eeghiloost = ['ethologies', 'theologies']
aceiinottx = ['excitation', 'intoxicate']
aaeehilrtx = ['exhilarate', 'heteraxial']
aefhinorss = ['fashioners', 'refashions']
afiilnortt = ['filtration', 'flirtation']
fgiillnrty = ['flirtingly', 'triflingly']
aeginrrstu = ['garnitures', 'treasuring']
aghlloossy = ['glossohyal', 'hyoglossal']
eegimnoors = ['gonomeries', 'merogonies']
egiinrsstt = ['grittiness', 'stringiest']
aeeghmnort = ['hatemonger', 'thereamong']
abdeehinrt = ['hibernated', 'inbreathed']
aehlnopstu = ['houseplant', 'sulphonate']
dhhioortyy = ['hyothyroid', 'thyrohyoid']
ceiiorsttu = ['icteritous', 'triticeous']
acdeeimprt = ['imprecated', 'mercaptide']
aeegimnprt = ['impregnate', 'permeating']
eeiimprssv = ['impressive', 'permissive']
ddeiinopss = ['indisposed', 'possidendi']
aceilnostu = ['inoculates', 'inosculate']
aeillnrsst = ['installers', 'reinstalls']
aeeginrstt = ['integrates', 'interstage']
adeeginrrt = ['intergrade', 'retreading']
aeilnoprrt = ['interpolar', 'reniportal']
cdeiimorty = ['iridectomy', 'mediocrity']
aaabillnos = ['labionasal', 'nasolabial']
adeelnrrsu = ['launderers', 'relaunders']
eeghilnrst = ['lighteners', 'sheltering']
deeiilrstz = ['listerized', 'sterilized']
aekmorrstw = ['masterwork', 'workmaster']
eeiilmnsst = ['melitensis', 'timeliness']
eeimnnorst = ['mentioners', 'minestrone']
aehmoprtty = ['metatrophy', 'metropathy']
cehimnoopr = ['microphone', 'neomorphic']
adegiilmns = ['misaligned', 'misdealing', 'misleading']
aeiilmorst = ['molarities', 'moralities']
eimnoorsst = ['montessori', 'sensimotor']
cemoorssuu = ['mucoserous', 'seromucous']
ailmorsttu = ['mutilators', 'stimulator']
aceilnnoop = ['napoleonic', 'pinacolone']
aegiimnstv = ['negativism', 'timesaving']
eehmnooprt = ['nephrotome', 'phonometer']
eehmnorstt = ['nethermost', 'stenotherm']
aaillnorty = ['notarially', 'rationally']
chimoooprs = ['osmophoric', 'sophomoric']
aceeiortvv = ['overactive', 'revocative']
aaellnprty = ['paternally', 'prenatally']
aeginprstt = ['patterings', 'spattering']
aceilnoptu = ['peculation', 'unpoetical']
acdeeiprst = ['pederastic', 'predicates']
eeimnopprt = ['peremption', 'preemption']
efgimnoprr = ['performing', 'preforming']
eeinprsstt = ['persistent', 'pinsetters', 'prettiness']
aegiinnprt = ['pertaining', 'repainting']
ceghinopty = ['phytogenic', 'pythogenic']
adeilpsttu = ['platitudes', 'stipulated']
eeloprssty = ['polyesters', 'presystole', 'proselytes']
aiilnoopst = ['positional', 'spoilation', 'spoliation']
aaeinoprrt = ['praetorian', 'reparation']
eeginprstt = ['presetting', 'pretesting']
aaeilnorst = ['rationales', 'senatorial']
aegilnortu = ['regulation', 'urogenital']
cddeeinrtu = ['reinducted', 'uncredited', 'undirected']
aabeeellrs = ['releasable', 'resealable']
ceeinorsst = ['resections', 'secretions']
aceilrstuv = ['revictuals', 'victualers']
ceiinrsstu = ['scrutinies', 'scrutinise']
efhllossuv = ['shovelfuls', 'shovelsful']
aegilnrstv = ['starveling', 'travelings']
efhiorsttu = ['stouthrief', 'stouthrife']
aeeiprsstt = ['striptease', 'tapestries']
aehirssttw = ['swarthiest', 'sweatshirt']
adeenrrstu = ['unarrested', 'underrates']
adeeelnrsu = ['underlease', 'unreleased']
cdeeilnnsu = ['unlicensed', 'unsilenced']
aabceeinrrs = ['aberrancies', 'carabineers']
aacceelorrt = ['accelerator', 'retrocaecal']
aaciinosttv = ['activations', 'cavitations', 'vacationist']
aabdiilorty = ['adorability', 'roadability']
adeenrrstuv = ['adventurers', 'untraversed']
acghiilmort = ['algorithmic', 'logarithmic']
aaehillopst = ['allopathies', 'lalopathies']
aeghilnoost = ['anthologies', 'theologians']
aceiinprtty = ['antipyretic', 'pertinacity']
adehiorrsst = ['arthrodesis', 'diarthroses']
aginooopsst = ['atopognosis', 'topognosias']
aegiimnnrtt = ['attermining', 'terminating']
abehiimorsv = ['behaviorism', 'misbehavior']
aabcdeorrst = ['broadcaster', 'rebroadcast']
aceeilnrstv = ['cantilevers', 'trivalences']
abceefiilrt = ['certifiable', 'rectifiable']
acdeiiossst = ['cestodiasis', 'dissociates']
aceilnopstt = ['cinetoplast', 'spinotectal', 'tectospinal', 'tenoplastic']
aciillnoost = ['colonialist', 'oscillation']
cdemnooprsu = ['compounders', 'recompounds']
cdeiinnoort = ['conditioner', 'recondition']
acdeinoorst = ['coordinates', 'decorations']
aceeilnnort = ['crenelation', 'intolerance']
abceinnorty = ['cybernation', 'cybernatoin']
accegilmoty = ['cytomegalic', 'megalocytic']
aacdeilmnot = ['declamation', 'nematocidal']
addegilmnny = ['demandingly', 'maddeningly']
adeinnoostt = ['denotations', 'detonations']
adeeilmnrst = ['derailments', 'streamlined']
adehhioppst = ['diphosphate', 'phosphatide']
cdeeimnnrst = ['discernment', 'rescindment']
cdeeiorrssv = ['discoverers', 'rediscovers']
aeehnorrsst = ['enarthroses', 'nearthroses']
ceeennorrtu = ['encounterer', 'reencounter']
eeeghilnnrt = ['enlightener', 'reenlighten']
deeiiinrstt = ['enteritidis', 'retinitides']
aeeimnnortu = ['enumeration', 'mountaineer']
abeehilrsst = ['establisher', 'reestablish']
aceiinosttx = ['excitations', 'intoxicates']
abfimmoorsy = ['fibromyomas', 'myofibromas']
adefnorrssw = ['forwardness', 'frowardness']
acgimnoorst = ['gastronomic', 'monogastric']
aeghmnooprs = ['gramophones', 'monographes']
aeghmoprrty = ['graphometry', 'metrography']
aehhimoprty = ['hemiatrophy', 'hypothermia']
chiiinorsst = ['histrionics', 'trichinosis']
aeeiimprstv = ['imperatives', 'semiprivate']
aeimnoprttu = ['importunate', 'permutation']
eiimnoprsss = ['impressions', 'permissions']
aceilnooprr = ['incorporeal', 'pericoronal']
aadeiilnstv = ['insalivated', 'invalidates']
aegiinnortt = ['integration', 'orientating']
aceiimnortt = ['interatomic', 'metrication']
eeeinprrrtt = ['interpreter', 'reinterpret']
egiiilnrstz = ['listerizing', 'sterilizing']
aeghiloopst = ['logopathies', 'pathologies']
aeimmoosstt = ['mastotomies', 'stomatomies']
aeimnnorstu = ['mensuration', 'numerations']
acghimnoopr = ['monographic', 'phonogramic']
aeghimoprsy = ['myographies', 'semiography']
emmnooottyy = ['myotenotomy', 'tenomyotomy']
deeeilnrssz = ['nesslerized', 'slenderizes']
aaciiloprst = ['paracolitis', 'piscatorial']
aaeinopprrt = ['paraprotein', 'preparation']
adeiinoprtt = ['partitioned', 'trepidation']
aeiimnoprst = ['patrimonies', 'spermiation']
ceinoprsssu = ['percussions', 'supersonics']
aceiilprstt = ['peristaltic', 'triplicates']
eeiinoprstt = ['petitioners', 'repetitions']
eeghilnoops = ['phenologies', 'pigeonholes']
cdeeeoprrss = ['predecessor', 'reprocessed']
abeinooprrt = ['probationer', 'reprobation']
ceeoprrsstt = ['protectress', 'retrospects']
aaeiilnortz = ['rationalize', 'realization']
ceeinnoorrt = ['reconnoiter', 'reconnoitre']
aegiinnrstt = ['reinstating', 'straitening']
eeeioprrrst = ['repertoires', 'repertories']
cceghiinort = ['ricocheting', 'trichogenic']
abccilorstu = ['scorbutical', 'subcortical']
aceehioprst = ['spirochaete', 'spirochetae']
achhioprtty = ['trichopathy', 'trichophyta']
aceiilnrstu = ['unclarities', 'unrealistic']
ceeeginrstv = ['vicegerents', 'viceregents']
aabdefimnoor = ['adenofibroma', 'fibroadenoma']
aadegilnrttu = ['adulterating', 'triangulated']
aaegiilmnort = ['ameliorating', 'emigrational']
aaceehioprst = ['apothecaries', 'spirochaetae']
aabcdeorrsst = ['broadcasters', 'rebroadcasts']
cdeeinorrstu = ['centruroides', 'reintroduces']
aciillnoosst = ['colonialists', 'oscillations']
ceiimmnoorss = ['commissioner', 'recommission']
aceinnoorstv = ['conservation', 'conversation']
aceinnorrsst = ['constrainers', 'contrariness']
ceeinoprsstu = ['counterspies', 'persecutions']
cehmoossstuu = ['customhouses', 'customshouse']
acdeeeilnsst = ['delicateness', 'delicatessen']
adeiilnoopst = ['depositional', 'despoliation']
adegiilnprsy = ['despairingly', 'redisplaying']
aeiilmmnoost = ['emotionalism', 'laminotomies']
eeeghilnnrst = ['enlighteners', 'reenlightens']
acehiinssttu = ['enthusiastic', 'unchastities']
aeehiooprstt = ['erotopathies', 'heterotopias']
aabfimmoorty = ['fibromyomata', 'myofibromata']
aabdehhirrst = ['hairbreadths', 'hairsbreadth']
eeiilmprssvy = ['impressively', 'permissively']
aciilnnoostu = ['inoculations', 'inosculation']
eeeinprrrstt = ['interpreters', 'reinterprets']
aeehiiknssst = ['kinaesthesis', 'kinesthesias']
aeegimnnoruv = ['manoeuvering', 'manoeuvreing']
aeehimoprstt = ['metatrophies', 'metropathies']
aceeilnoprss = ['narcolepsies', 'precessional']
eghilnooprst = ['nephrologist', 'phrenologist']
abcinorssttu = ['obscurantist', 'substraction', 'subtractions']
aeeinnoprstt = ['penetrations', 'presentation']
adeeeimprstt = ['preestimated', 'premeditates']
chiooopprrtt = ['prototrophic', 'trophotropic']
aeemnorrsstt = ['reassortment', 'remonstrates']
cdeeinrrsttu = ['reinstructed', 'unrestricted']
eeeghnnrrstt = ['restrengthen', 'strengthener']
eeinoprssssu = ['supersession', 'suspensories']
eeiimnprssuv = ['unimpressive', 'unpermissive']
acceemnorsttu = ['accouterments', 'accoutrements']
aaceiilnprstt = ['antiparticles', 'paternalistic']
aabghiooprtuy = ['autobiography', 'bioautography']
bcghilooopsyy = ['biopsychology', 'psychobiology']
aaaaceinrrssv = ['caravansaries', 'caravanserais']
accefiiinortt = ['certification', 'rectification']
accdhlnooorst = ['chondrocostal', 'costochondral']
ceiimmnoorsss = ['commissioners', 'recommissions']
ceiilopssttyy = ['cystopyelitis', 'pyelocystitis']
acdiiimnorrst = ['discriminator', 'doctrinairism']
bfiiimoorssty = ['fibromyositis', 'myofibrositis']
acefiinnorstu = ['functionaires', 'functionaries']
aabggiiillnov = ['gingivolabial', 'labiogingival']
aegiimnnoprst = ['impersonating', 'impregnations']
aaceiilnnortt = ['interactional', 'intercalation']
eeiilmnorstuy = ['myeloneuritis', 'neuromyelitis']
aaciiopprrstt = ['paraproctitis', 'participators']
acchimoopssty = ['psychosomatic', 'somatopsychic']
aehiilnoprsst = ['relationships', 'rhinoplasties']
eeeghnnrrsstt = ['restrengthens', 'strengtheners']
aeeelnssssstt = ['statelessness', 'tastelessness']
aaabdefimnoort = ['adenofibromata', 'fibroadenomata']
aacdhimooprtyy = ['cardiomyopathy', 'myocardiopathy']
accceeiilorsvv = ['cervicovesical', 'vesicocervical']
abceeloorrsttv = ['costovertebral', 'vertebrocostal']
beiiiilmprssty = ['impressibility', 'permissibility']
eiinoopprssstu = ['propitiousness', 'superpositions']
aabceelorrrstv = ['sacrovertebral', 'vertebrosacral']
chiioooprrssst = ['sporotrichosis', 'trichosporosis']
abefllnoopsstu = ['tablespoonfuls', 'tablespoonsful']
aeeinoooprrrstt = ['anteroposterior', 'posteroanterior']
aaadghiooprrtuy = ['autoradiography', 'radioautography']
cciimnnoorssttu = ['constructionism', 'misconstruction']
ehhilmnoooprtty = ['lithonephrotomy', 'nephrolithotomy']
acghhimooopprrt = ['microphotograph', 'photomicrograph']
aaceillopprsuuv = ['papulovesicular', 'vesiculopapular']
acghhloooppstyy = ['pathopsychology', 'psychopathology']
cdeiiiiloorssss = ['siderosilicosis', 'silicosiderosis']
aacddhilnooprssy = ['chondrodysplasia', 'dyschondroplasia']
aeehhmmnoooprtux = ['hemopneumothorax', 'pneumohemothorax']
ceeeegillmmnnooy = ['meningomyelocele', 'myelomeningocele']
acghhimooopprrty = ['microphotography', 'photomicrography']
acghhiiloooppsty = ['pathophysiologic', 'physiopathologic']
cehiiooprrsssttt = ['streptothricosis', 'streptotrichosis']
cdehiiiinooorrstt = ['choroidoretinitis', 'retinochoroiditis']
adehhmnoooprrtuxy = ['hydropneumothorax', 'pneumohydrothorax']
deeegiiilmmnnosty = ['meningomyelitides', 'myelomeningitides']
accghhiimooopprrt = ['microphotographic', 'photomicrographic']
aceghhiloooppssty = ['pathopsychologies', 'psychopathologies']
aeeehhmmnoooprstux = ['hemopneumothoraxes', 'pneumohemothoraxes']
aagghiilnnoprrstyy = ['laryngopharyngitis', 'pharyngolaryngitis']
aceghhiimooopprrst = ['microphotographies', 'photomicrographies']
adeghhiiinnoprrsty = ['pharyngorhinitides', 'rhinopharyngitides']
acdeeeehiillmnopsty = ['encephalomyelitides', 'myeloencephalitides']
adeehhmnoooprrstuxy = ['hydropneumothoraxes', 'pneumohydrothoraxes']
aadegghiilnnoprrstyy = ['laryngopharyngitides', 'pharyngolaryngitides']
acdeeeeghiiilmnnnopst = ['encephalomeningitides', 'meningoencephalitides']
